UnitID,Institution Name,Total  enrollment (DRVEF2013),Full-time equivalent fall enrollment (DRVEF2013),Full-time enrollment (DRVEF2013),Part-time enrollment (DRVEF2013)
457590,A & W Healthcare Educators,48,42,38,10
177834,A T Still University of Health Sciences,3314,2611,2177,1137
180203,Aaniiih Nakoda College,139,127,121,18
161615,Aaron's Academy of Beauty,39,38,37,2
459523,ABC Beauty Academy,35,30,26,9
106281,ABC Beauty College Inc,32,29,27,5
461892,Abcott Institute,151,142,136,15
208123,Abdill Career College Inc,80,80,80,0
222178,Abilene Christian University,4461,4074,3831,630
210456,Abington Memorial Hospital Dixon School of Nursing,224,219,216,8
138558,Abraham Baldwin Agricultural College,3394,2771,2350,1044
480444,Abraham Lincoln University,144,55,0,144
421896,Academia Serrant Inc,390,390,390,0
172866,Academy College,149,124,108,41
449463,Academy Di Capelli-School of Cosmetology,29,22,18,11
476957,Academy di Firenze,20,20,20,0
457989,Academy for Careers and Technology,50,50,50,0
451079,Academy for Five Element Acupuncture,77,77,77,0
457271,Academy for Jewish Religion-California,63,42,29,34
412173,Academy for Nursing and Health Occupations,694,694,694,0
462062,Academy for Salon Professionals,83,64,51,32
461980,Academy for Salon Professionals,228,192,169,59
461616,Academy of Aesthetic Arts,29,20,14,15
108232,Academy of Art University,16001,11750,9038,6963
451097,Academy of Career Training,152,89,47,105
237729,Academy of Careers and Technology,124,78,55,69
108269,Academy of Chinese Culture and Health Sciences,132,120,113,19
372462,Academy of Cosmetology,144,140,137,7
449852,Academy of Cosmetology,64,59,56,8
459569,Academy of Cosmetology,19,19,19,0
179991,Academy of Cosmetology,42,42,42,0
457855,Academy of Cosmetology and Esthetics NYC,130,116,107,23
475635,Academy of Couture Art,21,17,14,7
454722,Academy of Esthetics and Cosmetology,23,21,19,4
434283,Academy of Hair Design-Beaumont,86,86,86,0
175722,Academy of Hair Design-Grenada,40,40,40,0
374316,Academy of Hair Design-Jackson,121,94,77,44
447449,Academy of Hair Design-Jasper,57,44,35,22
181880,Academy of Hair Design-Las Vegas,154,154,154,0
434274,Academy of Hair Design-Lufkin,99,74,57,42
455929,Academy of Hair Design-Oklahoma City,55,39,28,27
382461,Academy of Hair Design-Pearl,65,58,53,12
208080,Academy of Hair Design-Salem,56,56,56,0
451334,Academy of Hair Design-Springfield,96,90,86,10
376446,Academy of Hair Technology,84,71,63,21
136048,Academy of Healing Arts Massage & Facial Skin Care,98,77,63,35
482185,Academy of Interactive Entertainment,43,43,43,0
451051,Academy of Massage and Bodywork,68,37,16,52
437501,Academy of Massage Therapy,75,75,75,0
449454,Academy of Natural Therapy Inc,69,64,60,9
107293,Academy of Salon and Spa,75,75,75,0
480879,Academy of Salon Professionals,26,26,26,0
210508,Academy of Vocal Arts,29,29,29,0
159443,Acadiana Technical College-Lafayette Campus,2832,1820,1308,1524
461342,Acaydia School of Aesthetics,13,12,12,1
476504,Access Careers,301,174,91,210
449676,Ace Computer Training Center,119,47,0,119
480736,Ace Cosmetology and Barber Training Center,16,14,12,4
384306,Acupuncture and Integrative Medicine College-Berkeley,140,119,106,34
439969,Acupuncture and Massage College,173,152,138,35
126182,Adams State University,3211,2573,2185,1026
188429,Adelphi University,7645,6655,6034,1611
419314,Adirondack Beauty School,24,24,24,0
188438,Adirondack Community College,4230,3139,2588,1642
374024,Adler Graduate School,380,145,0,380
142832,Adler School of Professional Psychology,981,852,772,209
168528,Adrian College,1658,1617,1591,67
119951,Adrian's College of Beauty Modesto,275,275,275,0
262369,Adrian's College of Beauty Turlock,157,157,157,0
203030,Adult and Community Education-Hudson,140,131,126,14
183983,Adult and Continuing Education-BCTS,105,105,105,0
400187,Advance Beauty College,506,423,368,138
479974,Advance Beauty Techs Academy,61,52,46,15
444334,Advance Science Institute,39,39,39,0
444352,Advance Tech College,55,55,55,0
437608,Advanced Barber College and Hair Design,164,164,164,0
458052,Advanced Beauty College,60,24,0,60
480019,Advanced Career Institute,241,224,212,29
444343,Advanced College,227,227,227,0
461786,Advanced College of Cosmetology,51,51,51,0
481234,Advanced Computing Institute,211,211,211,0
238166,Advanced Institute of Hair Design-Glendale,121,121,121,0
467809,Advanced Institute of Hair Design-Madison,98,98,98,0
383172,Advanced Technical Centers,35,35,35,0
231411,Advanced Technology Institute,824,824,824,0
444361,Advanced Training Associates,103,103,103,0
461430,Advanced Training Institute,308,122,0,308
456001,Advanced Welding Institute,53,53,53,0
133872,Adventist University of Health Sciences,2293,1348,737,1556
205391,Advertising Art Educational Services DBA School of Advertising Art,140,139,138,2
429012,Aerosim Flight Academy,74,74,74,0
476878,Aesthetic Science Institute,79,48,27,52
161651,Aesthetics Institute of Cosmetology,40,27,18,22
138600,Agnes Scott College,915,904,897,18
134811,AI Miami International University of Art and Design,3208,2738,2435,773
152822,AIB College of Business,1019,845,732,287
457998,Aiken School of Cosmetology,33,30,28,5
217615,Aiken Technical College,2583,1502,955,1628
419147,Ailano School of Cosmetology,36,30,26,10
126207,Aims Community College,4955,3029,2056,2899
200697,Air Force Institute of Technology-Graduate School of Engineering & Management,853,716,638,215
200785,Akron Institute of Herzing University,302,235,191,111
200828,Akron School of Practical Nursing,34,34,34,0
100654,Alabama A & M University,5020,4660,4439,581
101949,Alabama Southern Community College,1349,1041,886,463
371034,Alabama State College of Barber Styling,26,26,26,0
100724,Alabama State University,6075,5525,5182,893
199786,Alamance Community College,4161,2644,1877,2284
102580,Alaska Bible College,42,29,21,21
103501,Alaska Career College,335,335,335,0
442523,Alaska Christian College,53,51,49,4
102669,Alaska Pacific University,669,457,323,346
418038,Albany BOCES-Adult Practical Nursing Program,136,136,136,0
188526,Albany College of Pharmacy and Health Sciences,1639,1614,1599,40
188535,Albany Law School,594,559,538,56
188580,Albany Medical College,830,830,830,0
138716,Albany State University,4260,3636,3241,1019
138682,Albany Technical College,3894,2696,2091,1803
417178,Albert I Prince Technical High School,55,55,55,0
128498,Albertus Magnus College,1582,1513,1469,113
168546,Albion College,1307,1286,1272,35
210571,Albright College,2384,2342,2315,69
175342,Alcorn State University,3848,3272,2917,931
237118,Alderson Broaddus University,1117,1082,1060,57
181145,Alegent Creighton Health School of Radiologic Technology,22,22,22,0
476735,Alexander Academy,29,29,29,0
368036,Alexandria School of Scientific Therapeutics,30,30,30,0
172918,Alexandria Technical & Community College,2845,1934,1474,1371
188641,Alfred University,2431,2214,2079,352
393524,Alhambra Beauty College,159,159,159,0
156189,Alice Lloyd College,631,616,606,25
459125,All Beauty College,75,75,75,0
474997,All-State Career School-Allied Health Campus,350,350,350,0
210599,All-State Career School-Lester,343,343,343,0
418658,All-State Career School-Pittsburgh,364,364,364,0
373784,All-State Career-Baltimore,1078,1078,1078,0
108807,Allan Hancock College,10885,5910,3395,7490
161688,Allegany College of Maryland,3191,2213,1719,1472
210669,Allegheny College,2161,2139,2125,36
200873,Allegheny Wesleyan College,43,36,31,12
152798,Allen College,581,396,279,302
154642,Allen County Community College,2852,1839,1327,1525
188650,Allen School-Brooklyn,742,641,574,168
415987,Allen School-Jamaica,486,394,333,153
469610,Allen School-Phoenix,823,823,823,0
217624,Allen University,651,641,635,16
110468,Alliant International University,4201,2872,2038,2163
460729,Allied American University,2628,1438,668,1960
367316,Allied Health Careers,177,177,177,0
454883,Allied Health Institute,632,632,632,0
461111,Allstate Hairstyling & Barber College,35,31,28,7
168591,Alma College,1419,1394,1378,41
168607,Alpena Community College,1712,1153,870,842
366447,Altamaha Technical College,1244,654,356,888
210748,Altoona Beauty School Inc,68,47,33,35
447254,Alvareitas College of Cosmetology-Belleville,18,18,18,0
142869,Alvareitas College of Cosmetology-Edwardsville,45,33,25,20
142878,Alvareitas College of Cosmetology-Godfrey,40,40,40,0
210775,Alvernia University,2871,2231,1824,1047
238193,Alverno College,2536,2056,1750,786
222567,Alvin Community College,5118,2687,1459,3659
222576,Amarillo College,10873,5760,3175,7698
222628,Amberton University,1403,941,653,750
476771,Ambiance Beauty & Barber Academy Inc,24,20,17,7
457527,Ambria College of Nursing,344,290,254,90
420194,Amerian National College,115,115,115,0
188687,American Academy McAllister Institute of Funeral Service,408,222,100,308
446002,American Academy of Acupuncture and Oriental Medicine,65,46,35,30
142887,American Academy of Art,406,341,299,107
457396,American Academy of Cosmetology,120,93,75,45
108852,American Academy of Dramatic Arts-Los Angeles,258,258,258,0
188678,American Academy of Dramatic Arts-New York,216,216,216,0
481164,American Academy of Personal Training,106,90,80,26
444370,American Advanced Technicians Institute,97,97,97,0
393649,American Auto Institute,1444,1444,1444,0
219505,American Baptist College,144,117,99,45
108861,American Baptist Seminary of the West,49,37,29,20
431637,American Beauty Academy,812,639,525,287
459541,American Beauty Academy,32,26,22,10
108977,American Beauty College,45,31,21,24
365453,American Beauty Institute,17,17,17,0
189477,American Beauty School,194,135,96,98
441195,American Broadcasting School-Arlington,54,54,54,0
206783,American Broadcasting School-Oklahoma City,24,24,24,0
475255,American Broadcasting School-Online Program,81,81,81,0
457688,American Business and Technology University,1822,1822,1822,0
439905,American Career College at St Francis,47,47,47,0
441052,American Career College-Anaheim,1565,1565,1565,0
481854,American Career College-Long Beach,401,401,401,0
109040,American Career College-Los Angeles,1770,1770,1770,0
447768,American Career College-Ontario,1634,1634,1634,0
429085,American College of Acupuncture and Oriental Med,130,99,80,50
449889,American College of Education,3021,3021,3021,0
210809,American College of Financial Services,27749,10892,0,27749
179229,American College of Hair Design Inc,26,26,26,0
153092,American College of Hairstyling-Cedar Rapids,11,11,11,0
153588,American College of Hairstyling-Des Moines,21,21,21,0
422835,American College of Healthcare,290,290,290,0
483009,American College of Healthcare,73,73,73,0
443599,American College of Healthcare Sciences,387,172,35,352
430591,American College of Traditional Chinese Medicine,268,222,193,75
222707,American Commercial College-Odessa,23,17,13,10
222673,American Commercial College-San Angelo,81,67,57,24
423582,American Commercial College-Wichita Falls,120,104,93,27
109086,American Conservatory Theater,31,31,31,0
241146,American Educational College,560,558,557,3
108870,American Film Institute Conservatory,348,310,287,61
153463,American Hair Academy,32,32,32,0
461670,American Health Institute,68,67,67,1
103787,American Indian College of the Assemblies of God Inc,79,72,68,11
172927,American Indian OIC Inc,136,135,135,1
461005,American Institute,269,247,233,36
441636,American Institute of Alternative Medicine,263,237,220,43
447883,American Institute of Beauty,65,49,39,26
404037,American Institute of Interior Design,32,32,32,0
447795,American Institute of Massage Therapy,28,28,28,0
455202,American Institute of Medical Sciences & Education,274,274,274,0
476638,American Institute of Medical Sonography,21,21,21,0
449728,American Institute of Medical Technology,65,65,65,0
103811,American Institute of Technology,278,278,278,0
443234,American Institute-Margate,240,240,240,0
482963,American Institute-Toms River,140,140,140,0
438586,American InterContinental University-Atlanta,1103,662,378,725
445133,American InterContinental University-Houston,521,390,306,215
445027,American InterContinental University-Online,11619,8271,6119,5500
438601,American InterContinental University-South Florida,164,127,104,60
164447,American International College,3657,2463,1722,1935
116846,American Jewish University,229,204,188,41
475714,American Medical Academy,343,289,253,90
461263,American Medical Sciences Center,77,77,77,0
188854,American Musical and Dramatic Academy,1365,1365,1365,0
376987,American National College,102,102,102,0
232797,American National University,1857,1390,1088,769
449339,American Public University System,55422,23953,3786,51636
109208,American River College,29701,14994,7560,22141
240736,American Samoa Community College,1488,1039,735,753
158158,American School of Business,85,71,61,24
203225,American School of Technology,250,250,250,0
460738,American Sentinel University,3676,1727,484,3192
461625,American Technical Institute,6,6,6,0
461573,American Trade School,97,97,97,0
131159,American University,12818,11224,10233,2585
433004,American University of Health Sciences,287,287,287,0
241128,American University of Puerto Rico,1082,1003,953,129
241100,American University of Puerto Rico,968,887,836,132
447263,AmeriTech College-Draper,1036,1036,1036,0
229957,AmeriTech College-Provo,156,156,156,0
164465,Amherst College,1785,1785,1785,0
100690,Amridge University,631,442,323,308
151865,Anabaptist Mennonite Biblical Seminary,101,58,31,70
444389,Anamarc College-El Paso Central,347,347,347,0
480152,Anamarc College-El Paso East,269,265,263,6
459815,Anamarc College-Santa Teresa,96,96,96,0
150048,Ancilla College,424,340,284,140
150066,Anderson University,2442,2046,1797,645
217633,Anderson University,2966,2471,2156,810
164474,Andover Newton Theological School,272,140,59,213
138761,Andrew College,316,312,309,7
168740,Andrews University,3516,2783,2324,1192
457299,Angeles College,145,125,112,33
457314,Angeles Institute,105,105,105,0
222822,Angelina College,5490,3226,2081,3409
222831,Angelo State University,6536,5701,5177,1359
410256,Ann Arbor Institute of Massage Therapy,80,80,80,0
455248,Ann Marie's World of Beauty School,4,4,4,0
164492,Anna Maria College,1540,1152,907,633
161767,Anne Arundel Community College,16463,8809,4940,11523
475705,Annenberg School of Nursing,12,12,12,0
172954,Anoka Technical College,2249,1433,1021,1228
172963,Anoka-Ramsey Community College,9320,5229,3161,6159
109350,Antelope Valley College,14262,7783,4509,9753
445601,Anthem Career College-Memphis,883,883,883,0
440110,Anthem Career College-Nashville,402,402,402,0
460668,Anthem College-Atlanta,356,356,356,0
450155,Anthem College-Brookfield,286,286,286,0
410539,Anthem College-Denver,207,207,207,0
443739,Anthem College-Fenton,282,282,282,0
440129,Anthem College-Irving,288,288,288,0
445610,Anthem College-Kansas City,74,74,74,0
176549,Anthem College-Maryland Heights,277,277,277,0
430050,Anthem College-Minnesota,132,132,132,0
436225,Anthem College-Orlando,491,491,491,0
104805,Anthem College-Phoenix,2238,2238,2238,0
446853,Anthem College-Portland,232,232,232,0
413635,Anthem College-Sacramento,257,257,257,0
442462,Anthem Institute-Cherry Hill,251,251,251,0
249140,Anthem Institute-Jersey City,435,435,435,0
442648,Anthem Institute-Las Vegas,289,289,289,0
445577,Anthem Institute-North Brunswick,293,293,293,0
184047,Anthem Institute-Parsippany,148,148,148,0
213312,Anthem Institute-Springfield,223,223,223,0
241182,Antilles School of Technical Careers,548,548,548,0
483018,Antioch College,186,185,185,1
245838,Antioch University-Los Angeles,986,791,666,320
245892,Antioch University-Midwest,310,200,131,179
245865,Antioch University-New England,725,640,587,138
442392,Antioch University-PhD Program in Leadership and Change,152,152,152,0
245847,Antioch University-Santa Barbara,375,308,265,110
245883,Antioch University-Seattle,884,645,495,389
201016,Antonelli College-Cincinnati,180,169,162,18
383950,Antonelli College-Hattiesburg,256,245,237,19
175528,Antonelli College-Jackson,485,419,375,110
210890,Antonelli Institute,189,189,189,0
250072,Antonelli Medical and Professional Institute,119,105,96,23
429094,AOMA Graduate School of Integrative Medicine,189,160,142,47
150075,Apex Academy of Hair Design Inc,9,9,9,0
441511,Apex School of Theology,767,687,636,131
188890,Apex Technical School,1292,1101,976,316
201034,Apollo Career Center,654,372,229,425
237127,Appalachian Beauty School,19,19,19,0
237136,Appalachian Bible College,285,231,197,88
449922,Appalachian College of Pharmacy,220,220,220,0
432348,Appalachian School of Law,219,217,216,3
197869,Appalachian State University,17838,16716,16021,1817
417716,Applied Technology Services,166,166,166,0
168786,Aquinas College,2001,1786,1649,352
219578,Aquinas College,574,359,220,354
176600,Aquinas Institute of Theology,149,85,45,104
126289,Arapahoe Community College,11621,5426,2295,9326
211088,Arcadia University,3905,3251,2844,1061
367936,Argosy University-Atlanta,1920,883,236,1684
145770,Argosy University-Chicago,1017,527,220,797
442222,Argosy University-Dallas,495,230,62,433
448734,Argosy University-Denver,398,219,106,292
366748,Argosy University-Hawaii,795,484,289,506
450526,Argosy University-Inland Empire,704,356,136,568
447272,Argosy University-Los Angeles,620,333,151,469
450535,Argosy University-Nashville,551,266,87,464
436438,Argosy University-Orange County,673,410,244,429
436094,Argosy University-Phoenix,743,440,251,492
456348,Argosy University-Phoenix Online Division,11746,11746,11746,0
452090,Argosy University-Salt Lake City,243,146,85,158
450544,Argosy University-San Diego,487,275,140,347
121983,Argosy University-San Francisco Bay Area,559,286,114,445
137148,Argosy University-Sarasota,793,340,58,735
420866,Argosy University-Schaumburg,493,284,153,340
439057,Argosy University-Seattle,365,186,73,292
428268,Argosy University-Tampa,533,279,121,412
173984,Argosy University-Twin Cities,1626,827,318,1308
419457,Argosy University-Washington DC,925,505,244,681
212568,Aria Health School of Nursing,208,208,208,0
103954,Arizona Academy of Beauty-East,47,47,47,0
262235,Arizona Academy of Beauty-North,55,55,55,0
103963,Arizona Automotive Institute,505,505,505,0
105899,Arizona Christian University,635,525,454,181
421708,Arizona College-Glendale,937,937,937,0
482990,Arizona College-Mesa,162,162,162,0
450951,Arizona Culinary Institute,136,136,136,0
446039,Arizona School of Acupuncture and Oriental Medicine,42,39,37,5
448886,Arizona State University-Downtown Phoenix,10400,9495,8918,1482
420574,Arizona State University-Polytechnic,3697,3251,2964,733
483124,Arizona State University-Skysong,10268,6837,4632,5636
104151,Arizona State University-Tempe,48702,44899,42498,6204
407009,Arizona State University-West,3661,3205,2911,750
450942,Arizona Summit Law School,953,752,627,326
104160,Arizona Western College,8000,4548,2803,5197
106306,Arkansas Baptist College,1027,930,867,160
106324,Arkansas Beauty College,46,45,44,2
371140,Arkansas Beauty School,36,31,28,8
106315,Arkansas Beauty School,37,31,27,10
106351,Arkansas College of Barbering and Hair Design,134,130,127,7
107327,Arkansas Northeastern College,1425,890,619,806
106449,Arkansas State University-Beebe,4380,2945,2220,2160
106458,Arkansas State University-Main Campus,13552,10356,8384,5168
420538,Arkansas State University-Mountain Home,1238,1006,889,349
440402,Arkansas State University-Newport,2057,1330,963,1094
106467,Arkansas Tech University,11369,8904,7283,4086
222877,Arlington Baptist College,245,229,218,27
222886,Arlington Career Institute,235,205,186,49
429100,Arlington Medical Institute,54,54,54,0
138789,Armstrong Atlantic State University,7101,5822,4987,2114
219587,Arnolds Beauty School,72,72,72,0
188915,Arnot Ogden Medical Center,79,77,76,3
482194,Arrojo Cosmetology School,85,78,74,11
201061,Art Academy of Cincinnati,215,206,201,14
109651,Art Center College of Design,1985,1785,1657,328
106360,Arthur's Beauty College Inc-Fort Smith,50,50,50,0
106494,Arthur's Beauty College Inc-Jacksonville,64,64,64,0
445540,Arthur's Beauty School Inc-Conway,67,67,67,0
445531,Arthur's Beauty School Inc-Pine Bluff,13,13,13,0
414063,Artistic Academy of Hair Design,179,161,149,30
460701,Artistic Nails and Beauty Academy-Lakeland,220,133,75,145
378886,Artistic Nails and Beauty Academy-Tampa,198,122,72,126
404994,ASA College,4706,4502,4368,338
156222,Asbury Theological Seminary,1440,957,658,782
156213,Asbury University,1797,1548,1390,407
461777,Ashdown College of Health Sciences,41,41,41,0
447777,Asher College,686,281,15,671
197887,Asheville-Buncombe Technical Community College,8092,4469,2638,5454
154022,Ashford University,58104,58088,58078,26
156231,Ashland Community and Technical College,3359,2339,1824,1535
201098,Ashland County-West Holmes Career Center,74,63,58,16
201104,Ashland University,5979,4421,3444,2535
201131,Ashtabula County Technical and Career Campus,159,99,68,91
475431,ASI Career Institute,11,11,11,0
393861,Asian American International Beauty College,142,117,101,41
391546,ASM Beauty World Academy,64,28,5,59
128577,Asnuntuck Community College,1715,1043,703,1012
480994,Aspen Beauty Academy of Laurel,59,55,52,7
454829,Aspen University,633,413,275,358
164535,Assabet Valley Regional Technical School,46,46,46,0
176619,Assemblies of God Theological Seminary,404,227,118,286
188942,Associated Beth Rivkah Schools,106,106,106,0
109721,Associated Technical College-Los Angeles,404,404,404,0
109730,Associated Technical College-San Diego,110,110,110,0
164562,Assumption College,2756,2410,2192,564
183600,Assumption College for Sisters,38,34,31,7
379746,Astrodome Career Centers,46,46,46,0
446127,ATA Career Education,228,228,228,0
447935,ATA College,427,427,427,0
461768,Atelier Esthetique Institute of Esthetics,128,95,74,54
440651,Atenas College,1269,1140,1056,213
476683,Athena Career Academy,188,188,188,0
201140,Athenaeum of Ohio,208,119,63,145
100812,Athens State University,3170,2084,1350,1820
246813,Athens Technical College,4563,2383,1281,3282
444325,ATI College-Norwalk,120,87,66,54
457730,Atlanta Beauty & Barber Academy,515,510,506,9
419244,Atlanta Institute of Music,193,151,124,69
138901,Atlanta Metropolitan State College,3016,2192,1635,1381
138938,Atlanta School of Massage,62,51,44,18
138840,Atlanta Technical College,4859,2802,1763,3096
138929,Atlanta's John Marshall Law School,579,443,359,220
186593,Atlantic Beauty & Spa Academy LLC,150,129,116,34
183655,Atlantic Cape Community College,7254,4877,3675,3579
439446,Atlantic Institute of Oriental Medicine,142,142,142,0
132374,Atlantic Technical Center,902,902,902,0
241216,Atlantic University College,1429,1191,1038,391
439455,ATS Institute of Technology,504,434,388,116
201159,Auburn Career Center,203,160,139,64
100858,Auburn University,24864,22532,21093,3771
100830,Auburn University at Montgomery,5084,3951,3223,1861
173045,Augsburg College,3554,2951,2567,987
417345,Augusta Area Dietetic Internship-University Hospital,12,12,12,0
447917,Augusta School of Massage,64,57,52,12
138956,Augusta Technical College,4379,2641,1762,2617
143084,Augustana College,2524,2515,2509,15
219000,Augustana College,1765,1656,1586,179
444556,Auguste Escoffier School of Culinary Arts-Austin,261,261,261,0
454810,Auguste Escoffier School of Culinary Arts-Boulder,351,351,351,0
201177,Aultman College of Nursing and Health Sciences,306,152,52,254
143118,Aurora University,4946,3959,3342,1604
222983,Austin College,1223,1221,1220,3
222992,Austin Community College District,41627,20270,9476,32151
247825,Austin Graduate School of Theology,60,33,16,44
476869,Austin Kade Academy,193,193,193,0
219602,Austin Peay State University,10399,8437,7150,3249
223001,Austin Presbyterian Theological Seminary,140,116,101,39
188988,Austin's School of Spa Technology,270,270,270,0
418782,Automeca Technical College-Aguadilla,211,211,211,0
419703,Automeca Technical College-Bayamon,579,579,579,0
419712,Automeca Technical College-Caguas,244,244,244,0
419721,Automeca Technical College-Ponce,217,217,217,0
211006,Automotive Training Center-Exton,354,326,308,46
448770,Automotive Training Center-Warminster,291,272,259,32
365213,Autry Technology Center,543,249,100,443
457679,Avalon School of Cosmetology,33,33,33,0
108649,Avalon School of Cosmetology-Alameda,186,124,83,103
474924,Avalon School of Cosmetology-Layton,172,112,72,100
104568,Avalon School of Cosmetology-Mesa,273,215,177,96
474915,Avalon School of Cosmetology-Phoenix,233,176,138,95
393977,Avance Beauty College,54,54,54,0
460057,Avant Gard The School,47,47,47,0
442295,Ave Maria School of Law,319,317,315,4
446048,Ave Maria University,988,974,965,23
451468,Aveda Fredric's Institute-Cincinnati,212,212,212,0
457563,Aveda Fredric's Institute-Indianapolis,208,208,208,0
159513,Aveda Institute-Baton Rouge,226,226,226,0
461652,Aveda Institute-Boise,67,60,56,11
455141,Aveda Institute-Chapel Hill,156,156,156,0
455877,Aveda Institute-Chicago,183,183,183,0
455275,Aveda Institute-Columbus,271,271,271,0
160320,Aveda Institute-Covington,1707,1707,1707,0
459277,Aveda Institute-Denver,485,485,485,0
475015,Aveda Institute-Des Moines,213,213,213,0
159522,Aveda Institute-Lafayette,116,116,116,0
469957,Aveda Institute-Los Angeles,175,175,175,0
173744,Aveda Institute-Minneapolis,489,489,489,0
461555,Aveda Institute-New Mexico,132,132,132,0
448071,Aveda Institute-New York,238,193,163,75
460862,Aveda Institute-Portland,348,260,202,146
451574,Aveda Institute-Provo,179,179,179,0
455354,Aveda Institute-San Antonio,303,303,303,0
451149,Aveda Institute-South Florida,619,619,619,0
451158,Aveda Institute-Tallahassee,666,666,666,0
476753,Aveda Institute-Tucson,118,107,99,19
458070,Avenue Five Institute,241,201,175,66
219170,Avera McKennan Hospital School of Radiologic Technology,20,20,20,0
219338,Avera Sacred Heart Hospital,18,18,18,0
231420,Averett University,906,880,864,42
449931,Averett University-Non-Traditional Programs,1221,708,382,839
448257,Avi Career Training,23,23,23,0
440059,Aviation Institute of Maintenance-Atlanta,542,529,521,21
427973,Aviation Institute of Maintenance-Chesapeake,235,228,223,12
441788,Aviation Institute of Maintenance-Dallas,341,324,313,28
227748,Aviation Institute of Maintenance-Houston,251,248,246,5
438735,Aviation Institute of Maintenance-Indianapolis,157,152,148,9
441496,Aviation Institute of Maintenance-Kansas City,92,90,89,3
482255,Aviation Institute of Maintenance-Las Vegas,42,41,40,2
445762,Aviation Institute of Maintenance-Manassas,77,75,73,4
457411,Aviation Institute of Maintenance-Orlando,268,267,266,2
250285,Aviation Institute of Maintenance-Philadelphia,385,362,347,38
447847,Aviator College of Aeronautical Science and Technology,126,126,126,0
176628,Avila University,1971,1699,1526,445
102711,AVTEC-Alaska's Institute of Technology,1347,652,301,1046
161800,Award Beauty School,170,148,133,37
158246,Ayers Career College,267,267,267,0
474863,Azusa Pacific Online University,726,413,210,516
109785,Azusa Pacific University,10755,8928,7783,2972
237145,B M Spurr School of Practical Nursing,36,36,36,0
164580,Babson College,3343,2851,2547,796
206817,Bacone College,965,896,851,114
458159,Bainbridge Graduate Institute,143,134,129,14
139010,Bainbridge State College,2695,1661,1139,1556
128586,Bais Binyomin Academy,59,59,59,0
476601,Bais HaMedrash and Mesivta of Baltimore,49,49,49,0
245777,Bais Medrash Elyon,54,54,54,0
449658,Bais Medrash Toras Chesed,114,113,113,1
414708,Baker College Center for Graduate Studies,5270,3049,1619,3651
444167,Baker College of Allen Park,3800,2728,2035,1765
404073,Baker College of Auburn Hills,3105,2017,1314,1791
404648,Baker College of Cadillac,1549,1157,903,646
404082,Baker College of Clinton Township,4383,3091,2256,2127
168847,Baker College of Flint,4977,3622,2746,2231
414160,Baker College of Jackson,2257,1540,1077,1180
171298,Baker College of Muskegon,4021,3153,2592,1429
168838,Baker College of Owosso,2828,2151,1713,1115
381617,Baker College of Port Huron,1039,788,626,413
154688,Baker University,3076,1997,1315,1761
109819,Bakersfield College,17770,9696,5615,12155
420705,Bakke Graduate University,126,51,4,122
414489,Baldwin Beauty School-North Austin,79,79,79,0
223056,Baldwin Beauty School-South Austin,76,76,76,0
417105,Baldwin Park Adult & Community Education,495,417,378,117
201195,Baldwin Wallace University,4053,3631,3363,690
150136,Ball State University,20503,18053,16588,3915
161864,Baltimore City Community College,5394,2988,1772,3622
434308,Baltimore School of Massage-Linthicum,312,234,183,129
469586,Baltimore School of Massage-York,45,37,32,13
161855,Baltimore Studio of Hair Design,72,61,53,19
164599,Bancroft School of Massage Therapy,66,26,0,66
189015,Bank Street College of Education,846,543,355,491
176664,Baptist Bible College,367,312,278,89
211024,Baptist Bible College & Seminary of Pennsylvania,918,693,549,369
106546,Baptist Health Schools-Little Rock,918,848,802,116
223083,Baptist Health System School of Health Professions,444,444,444,0
219639,Baptist Memorial College of Health Sciences,1101,725,482,619
223117,Baptist Missionary Association Theological Seminary,123,73,41,82
366793,Baptist Theological Seminary at Richmond,77,51,35,42
444398,Baptist University of the Americas,189,159,140,49
231280,Bar Palma Beauty Careers Academy,108,93,83,25
483054,Barber School of Pittsburgh,35,29,25,10
155070,Barclay College,260,229,209,51
189088,Bard College,2355,2278,2229,126
167792,Bard College at Simon's Rock,350,345,341,9
189097,Barnard College,2489,2473,2463,26
177719,Barnes-Jewish College Goldfarb School of Nursing,818,767,736,82
457961,Barone Beauty Academy,56,56,56,0
156277,Barrett and Company School of Hair Design,93,93,93,0
132471,Barry University,9030,7096,5887,3143
109907,Barstow Community College,3211,1857,1172,2039
197911,Barton College,1065,968,906,159
154697,Barton County Community College,5210,2680,1402,3808
235547,Bastyr University,1115,1054,1015,100
160977,Bates College,1791,1791,1791,0
235671,Bates Technical College,3704,2563,1987,1717
437103,Baton Rouge Community College,8043,5501,4216,3827
158334,Baton Rouge General Medical Center-Radiologic Technology,22,22,22,0
158325,Baton Rouge General Medical Center-School of Nursing,56,56,56,0
158343,Baton Rouge School of Computers,81,65,54,27
139074,Bauder College,751,536,397,354
168883,Bay de Noc Community College,2305,1537,1149,1156
380359,Bay Mills Community College,531,376,298,233
164632,Bay Path College,2357,1885,1588,769
164641,Bay State College,1204,943,774,430
164678,Bay State School of Technology,200,155,126,74
241225,Bayamon Central University,2065,1705,1476,589
444194,Bayamon Community College,147,147,147,0
223223,Baylor College of Medicine,1552,1552,1552,0
223232,Baylor University,15616,15248,15016,600
168892,Bayshire Academy of Beauty Craft Inc,41,27,18,23
476717,Be'er Yaakov Talmudic Seminary,298,298,298,0
384254,Beacon College,190,189,188,2
160995,Beal College,464,403,363,101
208248,Beau Monde College of Hair Design,126,126,126,0
197966,Beaufort County Community College,2019,1253,866,1153
449357,Beaumont Adult School,118,118,118,0
481261,Beautiful You School of Nail Technology,17,16,15,2
234401,Beauty Academy,77,77,77,0
460969,Beauty Academy of South Florida,114,114,114,0
139092,Beauty College of America,53,53,53,0
374927,Beauty School of Middletown,68,52,41,27
468732,Beauty Schools of America,380,380,380,0
419660,Beauty Schools of America-Hialeah,777,777,777,0
456861,Beauty Schools of America-Homestead,655,655,655,0
135771,Beauty Schools of America-Miami,631,631,631,0
450182,Beauty Schools of America-North Miami Beach,482,482,482,0
207272,Beauty Technical College Inc,24,24,24,0
215336,Beaver Falls Beauty Academy,49,49,49,0
164720,Becker College,1902,1627,1449,453
247065,Beckfield College-Florence,807,616,492,315
452373,Beckfield College-Tri-County,554,395,290,264
130837,Beebe Medical Center Margaret H Rollins School of Nursing,55,55,55,0
444413,Beis Medrash Heichal Dovid,113,113,113,0
126359,Bel-Rea Institute of Animal Technology,576,576,576,0
190956,Belanger School of Nursing,123,72,38,85
175421,Belhaven University,4025,2426,1411,2614
364760,Bell Mar Beauty College,75,53,39,36
461193,Bella Capelli Academy,89,78,71,18
156286,Bellarmine University,3419,2966,2682,737
481571,Belle Academy of Cosmetology,6,5,5,1
444422,Bellefonte Academy of Beauty,141,141,141,0
234669,Bellevue College,13820,9576,6704,7116
180814,Bellevue University,9788,8569,7798,1990
238324,Bellin College,325,271,237,88
234696,Bellingham Technical College,2258,1592,1256,1002
478953,Bellus Academy,216,197,184,32
116563,Bellus Academy-El Cajon,184,184,184,0
109934,Bellus Academy-National City,185,185,185,0
377722,Bellus Academy-Poway,372,372,372,0
197984,Belmont Abbey College,1647,1587,1549,98
201283,Belmont College,1259,893,708,551
219709,Belmont University,6915,6417,6102,813
238333,Beloit College,1306,1274,1254,52
173124,Bemidji State University,4963,4112,3551,1412
237172,Ben Franklin Career Center,477,240,120,357
217721,Benedict College,2512,2486,2470,42
154712,Benedictine College,2177,1945,1796,381
145619,Benedictine University,6318,4639,3588,2730
137591,Benes International School of Beauty,281,281,281,0
165884,Benjamin Franklin Institute of Technology,482,439,412,70
439473,Bennett Career Institute,294,214,162,132
197993,Bennett College,680,637,609,71
230816,Bennington College,738,727,720,18
164739,Bentley University,5658,5186,4893,765
156295,Berea College,1623,1601,1587,36
183743,Bergen Community College,15882,11234,8885,6997
461643,Bergin University of Canine Studies,50,50,50,0
189219,Berk Trade and Business School,265,265,265,0
125170,Berkeley City College,6471,2869,1049,5422
189228,Berkeley College-New York,4596,4269,4058,538
183789,Berkeley College-Woodland Park,3671,3236,2954,717
164748,Berklee College of Music,4519,4243,4065,454
481021,Berks Career & Technology Center,59,44,37,22
213534,Berks Technical Institute,976,825,726,250
164775,Berkshire Community College,2400,1351,821,1579
139144,Berry College,2223,2161,2122,101
461865,Best Care Training Institute,78,78,78,0
189273,Beth Hamedrash Shaarei Yosher Institute,55,55,55,0
189264,Beth Hatalmud Rabbinical College,47,47,47,0
183804,Beth Medrash Govoha,6754,6285,5994,760
237181,Bethany College,726,721,718,8
154721,Bethany College,665,627,603,62
173142,Bethany Lutheran College,579,563,552,27
143233,Bethany Theological Seminary,60,41,29,31
458113,Bethel College,54,38,28,26
150145,Bethel College-Indiana,1804,1517,1333,471
154749,Bethel College-North Newton,482,471,464,18
369817,Bethel Seminary of the East,81,33,3,78
262022,Bethel Seminary-San Diego,178,93,41,137
173179,Bethel Seminary-St Paul,512,241,74,438
219718,Bethel University,6634,5811,5282,1352
173160,Bethel University,4340,3483,2942,1398
110060,Bethesda University of California,353,301,268,85
132602,Bethune-Cookman University,3787,3717,3671,116
139153,Beulah Heights University,788,519,347,441
102429,Bevill State Community College,3490,2373,1808,1682
443702,Bexley Hall Episcopal Seminary,15,13,11,4
457253,Beyond 21st Century Beauty Academy,46,27,15,31
211130,Biblical Theological Seminary,294,217,170,124
211149,Bidwell Training Center Inc,159,159,159,0
234711,Big Bend Community College,1991,1625,1440,551
157553,Big Sandy Community and Technical College,4715,3194,2425,2290
454731,BioHealth College,123,123,123,0
110097,Biola University,6301,5565,5107,1194
431026,BIR Training Center,1114,1093,1079,35
100937,Birmingham Southern College,1188,1175,1167,21
442949,Birthingway College of Midwifery,82,52,32,50
442213,Birthwise Midwifery School,58,34,19,39
102030,Bishop State Community College,3896,2750,2171,1725
200022,Bismarck State College,4062,3050,2365,1697
457721,Bitterroot School of Cosmetology,30,30,30,0
236018,BJ's Beauty & Barber College,121,121,121,0
143279,Black Hawk College,6574,3922,2581,3993
219037,Black Hills Beauty College,112,112,112,0
219046,Black Hills State University,4464,3290,2526,1938
106625,Black River Technical College,2248,1693,1412,836
143288,Blackburn College,543,531,523,20
180054,Blackfeet Community College,450,409,382,68
238397,Blackhawk Technical College,2637,1587,1056,1581
457615,Blackstone Valley Vocational Regional School District,50,17,0,50
198011,Bladen Community College,1199,761,539,660
366438,Blades School of Hair Design,92,61,40,52
447810,Blake Austin College,321,321,321,0
167464,Blessed John XXIII National Seminary,57,57,57,0
433165,Blessing Hospital School of Medical Laboratory Technology,4,4,4,0
143303,Blessing Hospital School of Radiologic Technology,20,20,20,0
143297,Blessing Rieman College of Nursing,256,209,178,78
223427,Blinn College,18561,12544,9503,9058
183822,Bloomfield College,1979,1856,1776,203
211158,Bloomsburg University of Pennsylvania,10127,9532,9155,972
444440,Blue Cliff Career College,82,82,82,0
450128,Blue Cliff College-Alexandria,231,194,169,62
450119,Blue Cliff College-Fayetteville,181,136,107,74
441502,Blue Cliff College-Gulfport,274,229,199,75
450021,Blue Cliff College-Houma,167,166,166,1
439491,Blue Cliff College-Lafayette,291,291,291,0
434821,Blue Cliff College-Metairie,603,473,388,215
439482,Blue Cliff College-Shreveport,320,239,186,134
243799,Blue Hills Regional Technical School,56,56,56,0
175430,Blue Mountain College,532,489,461,71
208275,Blue Mountain Community College,1880,1293,996,884
446774,Blue Ridge Community and Technical College,5020,2477,1191,3829
198039,Blue Ridge Community College,2324,1257,717,1607
231536,Blue Ridge Community College,4437,2557,1607,2830
446057,Blue Sky School of Professional Massage and Therapeutic Bodywork,39,39,39,0
442958,Blue Water College of Cosmetology Inc,57,43,33,24
231554,Bluefield College,842,772,726,116
237215,Bluefield State College,1747,1564,1440,307
156392,Bluegrass Community and Technical College,12365,7769,5446,6919
201371,Bluffton University,1146,1009,920,226
481553,Bly's School of Cosmetology,96,77,64,32
217749,Bob Jones University,3364,3036,2830,534
481483,Boca Beauty Academy,200,171,152,48
460950,Body Therapy Institute,64,64,64,0
476850,Boise Barber College,91,91,91,0
142090,Boise Bible College,186,174,167,19
142115,Boise State University,21981,16692,13264,8717
444316,Bold Beauty Academy,165,165,165,0
233356,Bon Secours Memorial College of Nursing,408,286,207,201
233480,Bon Secours St Mary's Hospital School of Medical Imaging,28,28,28,0
481456,Bonnie Joseph Academy of Cosmetology and Barbering,28,18,11,17
189413,Boricua College,1118,1118,1118,0
454759,Borner's Barber College,23,12,4,19
158431,Bossier Parish Community College,8464,6147,4976,3488
164872,Boston Architectural College,1037,927,856,181
164614,Boston Baptist College,96,82,73,23
164924,Boston College,14309,13452,12916,1393
164915,Boston Graduate School of Psychoanalysis Inc,147,85,46,101
164988,Boston University,32411,28341,25797,6614
161004,Bowdoin College,1795,1793,1791,4
162007,Bowie State University,5561,4583,3974,1587
201432,Bowling Green State University-Firelands,2441,1641,1236,1205
201441,Bowling Green State University-Main Campus,16958,15603,14764,2194
202161,Bradford School,449,449,449,0
211200,Bradford School,439,439,439,0
132675,Bradford-Union Technical Center,140,127,120,20
143358,Bradley University,5430,5112,4912,518
189422,Bramson ORT College,796,699,635,161
479992,Brand College,14,7,3,11
165015,Brandeis University,5825,5554,5386,439
262086,Brandman University,7746,4861,3037,4709
451042,Branford Academy of Hair and Cosmetology,64,37,20,44
448974,Branford Hall Career Institute-Albany Campus,378,303,254,124
195933,Branford Hall Career Institute-Bohemia Campus,795,636,532,263
128674,Branford Hall Career Institute-Branford Campus,524,423,357,167
434520,Branford Hall Career Institute-Southington Campus,541,438,371,170
438805,Branford Hall Career Institute-Springfield Campus,696,620,570,126
430096,Branford Hall Career Institute-Windsor Campus,449,375,326,123
223506,Brazosport College,4127,2242,966,3161
139199,Brenau University,2854,2041,1528,1326
455424,Brensten Education,402,402,402,0
156356,Brescia University,949,795,695,254
198066,Brevard College,701,694,690,11
367875,Brewster Technical Center,202,202,202,0
139205,Brewton-Parker College,693,578,503,190
152992,Briar Cliff University,1174,995,881,293
189459,Briarcliffe College,1886,1627,1459,427
445674,Bridgemont Community and Technical College,1162,679,435,727
128726,Bridgeport Hospital School of Nursing,171,163,158,13
230010,Bridgerland Applied Technology College,593,395,295,298
231581,Bridgewater College,1848,1843,1840,8
165024,Bridgewater State University,11267,9550,8473,2794
230047,Brigham Young University-Hawaii,2882,2653,2505,377
142522,Brigham Young University-Idaho,27692,19607,14376,13316
230038,Brigham Young University-Provo,31123,28675,27114,4009
442976,Brighton Center's Center for Employment Training,89,89,89,0
477002,Brighton Institute of Cosmetology,55,43,35,20
104294,Brillare Hairdressing Academy,226,168,129,97
165033,Bristol Community College,9335,6076,4429,4906
431187,Bristol Technical Education Center,45,45,45,0
397270,Bristol University,82,82,82,0
450304,Brite Divinity School,215,175,151,64
189468,Brittany Beauty School,144,124,111,33
449311,Brittany Beauty School,176,142,119,57
459091,Broadview Entertainment Arts University,151,129,115,36
467793,Broadview University-Boise,142,121,107,35
450429,Broadview University-Layton,163,127,104,59
454591,Broadview University-Orem,124,98,82,42
230056,Broadview University-West Jordan,237,182,147,90
206880,Broken Arrow Beauty College-Broken Arrow,90,89,89,1
448424,Broken Arrow Beauty College-Tulsa,88,80,74,14
183859,Brookdale Community College,14360,9751,7421,6939
223524,Brookhaven College,12319,5692,2342,9977
444088,Brookline College-Albuquerque,272,272,272,0
104090,Brookline College-Phoenix,844,844,844,0
404055,Brookline College-Tempe,223,223,223,0
438179,Brookline College-Tucson,420,420,420,0
189501,Brooklyn Law School,1135,999,915,220
110185,Brooks Institute,518,449,405,113
198075,Brookstone College-Charlotte,128,128,128,0
381644,Brookstone College-Greensboro,154,154,154,0
418010,Broome Delaware Tioga BOCES-Practical Nursing Program,61,34,20,41
132709,Broward College,43883,25667,13342,30541
441645,Brown Aveda Institute-Mentor,149,147,145,4
450395,Brown Aveda Institute-Rocky River,151,151,151,0
139214,Brown College of Court Reporting,233,132,66,167
475291,Brown College-Brooklyn Center,144,79,37,107
174394,Brown College-Mendota Heights,237,168,123,114
205647,Brown Mackie College-Akron,694,694,694,0
460039,Brown Mackie College-Albuquerque,780,780,780,0
410283,Brown Mackie College-Atlanta,1033,1033,1033,0
470162,Brown Mackie College-Birmingham,954,954,954,0
455600,Brown Mackie College-Boise,393,393,393,0
205610,Brown Mackie College-Cincinnati,1045,1045,1045,0
482954,Brown Mackie College-Dallas,308,308,308,0
375489,Brown Mackie College-Findlay,448,448,448,0
408039,Brown Mackie College-Fort Wayne,659,659,659,0
456791,Brown Mackie College-Greenville,845,845,845,0
421513,Brown Mackie College-Hopkinsville,284,284,284,0
451699,Brown Mackie College-Indianapolis,899,899,899,0
154767,Brown Mackie College-Kansas City,486,486,486,0
157599,Brown Mackie College-Louisville,1420,1420,1420,0
151616,Brown Mackie College-Merrillville,619,619,619,0
447290,Brown Mackie College-Miami,953,953,953,0
151625,Brown Mackie College-Michigan City,290,290,290,0
204316,Brown Mackie College-North Canton,563,563,563,0
157696,Brown Mackie College-Northern Kentucky,443,443,443,0
475042,Brown Mackie College-Oklahoma City,355,355,355,0
456612,Brown Mackie College-Phoenix,637,637,637,0
373085,Brown Mackie College-Quad Cities,364,364,364,0
154776,Brown Mackie College-Salina,508,508,508,0
460613,Brown Mackie College-San Antonio,785,785,785,0
151944,Brown Mackie College-South Bend,423,423,423,0
460048,Brown Mackie College-St Louis,634,634,634,0
104364,Brown Mackie College-Tucson,684,684,684,0
455619,Brown Mackie College-Tulsa,604,604,604,0
217156,Brown University,8943,8689,8527,416
110194,Brownson Technical School,45,45,45,0
198084,Brunswick Community College,1809,1226,932,877
180878,Bryan College of Health Sciences,711,487,343,368
219790,Bryan College-Dayton,1704,1428,1249,455
439826,Bryan College-Gold River,326,326,326,0
369516,Bryan University,448,448,448,0
454458,Bryan University,84,84,84,0
110219,Bryan University,927,927,927,0
475583,Bryan University,111,111,111,0
154794,Bryan University,88,88,88,0
475699,Bryant & Stratton College-Akron,313,201,129,184
188517,Bryant & Stratton College-Albany,580,438,346,234
189556,Bryant & Stratton College-Amherst,413,312,246,167
458502,Bryant & Stratton College-Bayshore,589,434,334,255
189583,Bryant & Stratton College-Buffalo,740,563,449,291
202684,Bryant & Stratton College-Cleveland,538,344,218,320
369905,Bryant & Stratton College-Eastlake,614,385,237,377
189592,Bryant & Stratton College-Greece,389,316,268,121
459107,Bryant & Stratton College-Hampton,641,441,311,330
410496,Bryant & Stratton College-Henrietta,412,340,293,119
239929,Bryant & Stratton College-Milwaukee,1051,667,418,633
480091,Bryant & Stratton College-Online,2140,1600,1251,889
201469,Bryant & Stratton College-Parma,662,457,324,338
231828,Bryant & Stratton College-Richmond,906,652,488,418
374972,Bryant & Stratton College-Southtowns,570,416,316,254
189574,Bryant & Stratton College-Syracuse,522,444,392,130
189565,Bryant & Stratton College-Syracuse North,452,357,295,157
231785,Bryant & Stratton College-Virginia Beach,728,506,362,366
451750,Bryant & Stratton College-Wauwatosa,760,571,449,311
217165,Bryant University,3454,3345,3276,178
210492,Bryn Athyn College of the New Church,278,270,265,13
211273,Bryn Mawr College,1738,1692,1663,75
446075,Buchanan Beauty College,21,21,21,0
469993,Buchanan Beauty College,19,15,13,6
211316,Buck's County School of Beauty Culture Inc,89,82,78,11
201478,Buckeye Hills Career Center,108,103,100,8
383312,Buckeye Joint Vocational School,89,89,89,0
211291,Bucknell University,3608,3576,3555,53
461740,Buckner Barber School,28,28,28,0
211307,Bucks County Community College,9880,5483,3260,6620
153001,Buena Vista University,2399,2131,1960,439
196130,Buffalo State SUNY,11091,9672,8799,2292
417187,Bullard-Havens Technical High School,21,21,21,0
165112,Bunker Hill Community College,14023,7798,4651,9372
230825,Burlington College,243,195,164,79
183877,Burlington County College,9570,6475,4910,4660
189653,Business Informatics Center Inc,56,40,29,27
211334,Butler Beauty Academy,52,52,52,0
154800,Butler Community College,9142,5800,4111,5031
211343,Butler County Community College,3686,2306,1608,2078
201496,Butler Tech-D Russel Lee Career Center,303,303,303,0
150163,Butler University,4827,4532,4348,479
180063,Butte Academy of Beauty Culture,37,37,37,0
110246,Butte College,12163,7947,5816,6347
444103,Byzantine Catholic Seminary of Saints Cyril and Methodius,11,9,7,4
198109,Cabarrus College of Health Sciences,451,280,169,282
237242,Cabell County Career Technology Center,130,90,70,60
110334,Cabrillo College,13666,7660,4625,9041
211352,Cabrini College,2448,1742,1303,1145
481304,Cactus Academy,97,78,65,32
364946,Caddo Kiowa Technology Center,198,114,72,126
169071,Cadillac Institute of Cosmetology,39,27,19,20
379135,Cain's Barber College Inc,85,78,73,12
215114,Cairn University-Langhorne,1093,929,826,267
446084,CALC Institute of Technology,201,86,11,190
183910,Caldwell College,2160,1712,1431,729
198118,Caldwell Community College and Technical Institute,3933,2373,1584,2349
110361,California Baptist University,7144,6361,5864,1280
110875,California Beauty School,114,98,88,26
447713,California Career College,78,31,0,78
481386,California Career Institute,45,26,14,31
262402,California Career School,212,212,212,0
110918,California Christian College,30,23,18,12
110370,California College of the Arts,1949,1873,1825,124
443429,California College of Vocational Careers,69,69,69,0
478625,California College San Diego,203,203,203,0
110945,California College San Diego,762,762,762,0
478634,California College San Diego,269,269,269,0
111054,California Hair Design Academy,219,219,219,0
442985,California Healing Arts College,9,9,9,0
110316,California Institute of Integral Studies,1271,1096,988,283
110404,California Institute of Technology,2181,2181,2181,0
111081,California Institute of the Arts,1489,1479,1472,17
110413,California Lutheran University,4282,3949,3740,542
111188,California Maritime Academy,1045,1023,1008,37
480781,California Miramar University,317,312,308,9
455734,California Nurses Educational Institute,223,223,223,0
110422,California Polytechnic State University-San Luis Obispo,19703,19139,18775,928
110529,California State Polytechnic University-Pomona,22501,20369,18995,3506
110486,California State University-Bakersfield,8371,7652,7190,1181
441937,California State University-Channel Islands,5140,4697,4401,739
110538,California State University-Chico,16356,15510,14960,1396
110547,California State University-Dominguez Hills,14670,11597,9599,5071
110574,California State University-East Bay,14526,12810,11733,2793
110556,California State University-Fresno,23060,20909,19511,3549
110565,California State University-Fullerton,38325,32657,29023,9302
110583,California State University-Long Beach,35586,31225,28440,7146
110592,California State University-Los Angeles,23258,20107,18104,5154
409698,California State University-Monterey Bay,5732,5410,5205,527
110608,California State University-Northridge,38310,33509,30423,7887
110617,California State University-Sacramento,28811,25142,22735,6076
110510,California State University-San Bernardino,18398,16444,15213,3185
366711,California State University-San Marcos,11300,10024,9177,2123
110495,California State University-Stanislaus,8917,7907,7256,1661
460075,California University of Management and Sciences,405,405,405,0
211361,California University of Pennsylvania,8243,7181,6527,1716
111391,California Western School of Law,704,646,610,94
150172,Calumet College of Saint Joseph,1140,824,622,518
211370,Calvary Baptist Theological Seminary,62,39,24,38
176789,Calvary Bible College and Theological Seminary,328,242,187,141
169080,Calvin College,4034,3921,3849,185
169099,Calvin Theological Seminary,306,266,241,65
428329,Cambria-Rowe Business College-Indiana,105,105,105,0
211398,Cambria-Rowe Business College-Johnstown,142,141,141,1
165167,Cambridge College,3114,1939,1198,1916
446109,Cambridge Institute of Allied Health & Technology,185,185,185,0
454865,Cambridge Institute of Health & Technology,204,200,198,6
460659,Cambridge Junior College-Woodland,96,96,96,0
446093,Cambridge Junior College-Yuba City,167,167,167,0
444264,Cambridge Technical Institute,144,130,121,23
183938,Camden County College,13301,9177,7092,6209
417549,Camelot College,267,267,267,0
143464,Cameo Beauty Academy,105,76,57,48
230065,Cameo College of Essential Beauty,228,142,85,143
158440,Cameron College,23,23,23,0
206914,Cameron University,5898,4615,3772,2126
198136,Campbell University,6122,5427,4981,1141
156365,Campbellsville University,3520,2713,2195,1325
111434,Canada College,6620,3021,1202,5418
365374,Canadian Valley Technology Center,1402,642,258,1144
189705,Canisius College,4537,3864,3443,1094
200208,Cankdeska Cikana Community College,254,191,159,95
401481,Cannella School of Hair Design-Blue Island,52,30,16,36
364812,Cannella School of Hair Design-Chicago,52,23,4,48
143491,Cannella School of Hair Design-Chicago,125,55,9,116
143482,Cannella School of Hair Design-Chicago,84,47,22,62
143516,Cannella School of Hair Design-Elgin,79,39,13,66
143473,Cannella School of Hair Design-Villa Park,83,41,14,69
458025,Cannon Institute of Higher Learning,11,11,11,0
201539,Canton City Schools Adult Career and Technical Education,91,77,70,21
165194,Cape Cod Community College,4051,2231,1311,2740
431558,Cape Coral Institute of Technology,330,330,330,0
198154,Cape Fear Community College,9246,6098,4507,4739
176798,Cape Girardeau Career and Technology Center,305,201,149,156
413413,Capella University,34007,14367,2108,31899
461704,Capilo School of Hair Design,176,176,176,0
367972,Capital Area School of Practical Nursing,131,131,131,0
158352,Capital Area Technical College,2324,1333,832,1492
129367,Capital Community College,4168,2059,993,3175
201548,Capital University,3628,3231,2980,648
223667,Capitol City Careers,10,10,10,0
223658,Capitol City Trade and Technical School,165,165,165,0
162061,Capitol College,843,623,485,358
365693,Capitol School of Hairstyling and Esthetics,144,128,118,26
457031,Capri Beauty College,49,49,49,0
143552,Capri Beauty College,86,70,59,27
143534,Capri Beauty College,32,32,32,0
153083,Capri College-Cedar Rapids,192,192,192,0
154448,Capri College-Davenport,190,190,190,0
153074,Capri College-Dubuque,122,122,122,0
407391,Capri Institute of Hair Design-Brick,172,142,123,49
363077,Capri Institute of Hair Design-Clifton,268,198,152,116
407407,Capri Institute of Hair Design-Kenilworth,153,127,110,43
407425,Capri Institute of Hair Design-Paramus,197,143,108,89
189714,Capri School of Hair Design,238,204,181,57
377759,Capstone College,50,50,50,0
455707,Cardiac and Vascular Institute of Ultrasound,38,38,38,0
238430,Cardinal Stritch University,4407,4150,3988,419
458034,Cardiotech Ultrasound School,61,56,52,9
111513,Career Academy of Beauty,167,111,74,93
107220,Career Academy of Hair Design,364,282,228,136
418205,Career and Technology Education Centers of Licking County,348,224,161,187
444468,Career Beauty College,27,27,27,0
446118,Career Care Institute,615,615,615,0
417442,Career Center of Southern Illinois,90,90,90,0
451006,Career College Consultants,146,122,106,40
449436,Career College of California,206,176,156,50
181941,Career College of Northern Nevada,556,556,556,0
454801,Career Development Institute,69,47,32,37
433013,Career Networks Institute,561,556,552,9
246008,Career Point College,236,236,236,0
224439,Career Point College,1208,1208,1208,0
469975,Career Quest Learning Center-Kalamazoo,99,99,99,0
454306,Career Quest Learning Centers-Jackson,329,329,329,0
446136,Career Quest Learning Centers-Lansing,422,422,422,0
455220,Career School of NY,62,62,62,0
367112,Career Technical College-Monroe,580,461,382,198
446880,Career Technical College-Shreveport,395,349,319,76
420370,Career Technical Institute,670,670,670,0
246071,Career Technology Center of Lackawanna County,76,76,76,0
408312,Career Training Academy-Monroeville,112,112,112,0
210951,Career Training Academy-New Kensington,163,163,163,0
440174,Career Training Academy-Pittsburgh,83,83,83,0
441858,Career Training Solutions,280,230,197,83
448239,Careers Unlimited,176,176,176,0
449746,Carib Technological Institute,59,59,59,0
441706,Caribbean Forensic and Technical College,189,189,189,0
241377,Caribbean University-Bayamon,1876,1582,1395,481
241386,Caribbean University-Carolina,827,692,606,221
363907,Caribbean University-Ponce,1529,1258,1087,442
363916,Caribbean University-Vega Baja,604,507,445,159
206923,Carl Albert State College,2458,1894,1609,849
143613,Carl Sandburg College,2328,1463,1026,1302
173258,Carleton College,2045,2033,2025,20
132842,Carlos Albizu University-Miami,991,745,591,400
241331,Carlos Albizu University-San Juan,919,829,773,146
211431,Carlow University,3012,2232,1732,1280
451194,Carlson College of Massage Therapy,26,26,26,0
169187,Carnegie Institute,241,163,112,129
211440,Carnegie Mellon University,12367,11697,11279,1088
199971,Carolina Christian College,53,53,53,0
461032,Carolina College of Biblical Studies,113,72,45,68
460765,Carolina College of Hair Design,59,59,59,0
198190,Carolina School of Broadcasting,57,47,40,17
433174,Carolinas College of Health Sciences,449,205,81,368
201618,Carousel Beauty College-Dayton,31,31,31,0
416980,Carousel Beauty College-Kettering,61,47,38,23
201609,Carousel Beauty College-Middletown,25,21,18,7
416971,Carousel Beauty College-Springfield,57,40,29,28
201627,Carousel of Miami Valley Beauty College,34,26,20,14
437927,Carrington College California-Antioch,49,49,49,0
450702,Carrington College California-Citrus Heights,451,432,420,31
438258,Carrington College California-Pleasant Hill,589,543,512,77
467368,Carrington College California-Pomona,301,264,240,61
125532,Carrington College California-Sacramento,1267,1193,1145,122
437936,Carrington College California-San Jose,693,674,662,31
246974,Carrington College California-San Leandro,521,511,505,16
450696,Carrington College California-Stockton,465,444,430,35
442602,Carrington College-Albuquerque,647,585,545,102
142054,Carrington College-Boise,552,518,496,56
457101,Carrington College-Las Vegas,255,236,224,31
103909,Carrington College-Mesa,691,651,624,67
475750,Carrington College-Mesquite,308,308,308,0
103893,Carrington College-Phoenix,676,676,676,0
250601,Carrington College-Phoenix Westside,513,420,358,155
246035,Carrington College-Portland,242,239,237,5
457110,Carrington College-Reno,333,285,254,79
439118,Carrington College-Spokane,538,538,538,0
103927,Carrington College-Tucson,440,438,437,3
180106,Carroll College,1431,1381,1349,82
405872,Carroll Community College,3785,2225,1437,2348
238458,Carroll University,3534,3147,2901,633
409166,Carson City Beauty Academy,93,92,92,1
219806,Carson-Newman University,2045,1870,1761,284
447430,Carsten Institute of Cosmetology,142,111,90,52
419156,Carsten Institute of Cosmetology,41,41,41,0
198206,Carteret Community College,1524,938,642,882
238476,Carthage College,2988,2741,2583,405
481049,Carthage R9 School District-Carthage Technical Center,11,11,11,0
139287,Carver Bible College,103,76,59,44
430795,Carver Career Center,278,267,261,17
111638,Casa Loma College-Van Nuys,606,606,606,0
203438,Casal Aveda Institute,156,120,97,59
455211,Casal Institute of Nevada,115,110,106,9
235954,Cascade Beauty College,24,24,24,0
439190,Cascadia Community College,2821,1969,1539,1282
201645,Case Western Reserve University,10325,9675,9270,1055
240505,Casper College,4082,2670,1957,2125
417682,Cass Career Center,28,28,28,0
230834,Castleton State College,2175,1994,1877,298
198215,Catawba College,1310,1250,1211,99
198233,Catawba Valley Community College,4561,2713,1779,2782
218089,Cathedral Bible College,156,139,128,28
165255,Catherine Hinds Institute of Esthetics,171,127,98,73
143659,Catholic Theological Union at Chicago,437,251,136,301
131283,Catholic University of America,6725,5511,4756,1969
417983,Cattaraugus Allegany BOCES-Practical Nursing Program,70,24,0,70
430306,Cayce Reilly School of Massotherapy,30,24,20,10
189839,Cayuga County Community College,4410,2965,2235,2175
430883,Cayuga Onondaga BOCES-Practical Nursing Program,34,34,34,0
189848,Cazenovia College,1077,992,937,140
439367,CBD College,230,230,230,0
456977,CBT College-Cutler Bay,174,174,174,0
375647,CC's Cosmetology College,47,47,47,0
449773,CCI Training Center-Arlington,199,157,130,69
447874,CDA Technical Institute,375,375,375,0
451495,CDE Career Institute,47,37,30,17
162104,Cecil College,2604,1564,1038,1566
211468,Cedar Crest College,1486,996,681,805
223773,Cedar Valley College,6676,3280,1564,5112
201654,Cedarville University,3462,3279,3163,299
454917,Celebrity School of Beauty,198,179,167,31
183974,Centenary College,2400,2130,1962,438
158477,Centenary College of Louisiana,661,610,578,83
379782,Center for Advanced Legal Studies,182,182,182,0
241793,Center for Advanced Studies On Puerto Rico and the Caribbean,503,377,299,204
455910,Center for Massage & Natural Health,58,58,58,0
449667,Center for Natural Wellness School of Massage Therapy,66,66,66,0
457651,CenterPoint Massage and Shiatsu Therapy School and Clinic,95,67,48,47
100760,Central Alabama Community College,1906,1273,953,953
104346,Central Arizona College,6445,3578,2129,4316
106713,Central Baptist College,827,720,650,177
154837,Central Baptist Theological Seminary,337,282,248,89
419183,Central California School,412,412,412,0
436003,Central Career Institute LLC,161,131,111,50
198251,Central Carolina Community College,4728,3055,2210,2518
218858,Central Carolina Technical College,4456,2392,1349,3107
154855,Central Christian College of Kansas,1037,857,741,296
176910,Central Christian College of the Bible,302,263,237,65
378105,Central Coast College,233,200,178,55
153108,Central College,1386,1358,1340,46
417725,Central College of Cosmetology,105,105,105,0
180902,Central Community College,6906,3790,2215,4691
128771,Central Connecticut State University,11865,9621,8208,3657
439525,Central Florida Institute,285,285,285,0
483045,Central Georgia Technical College,7796,4737,3191,4605
173203,Central Lakes College-Brainerd,4350,2908,2179,2171
158088,Central Louisiana Technical Community College,2242,1469,1079,1163
161077,Central Maine Community College,3109,2005,1447,1662
161022,Central Maine Medical Center College of Nursing and Health Professions,225,125,59,166
425870,Central Mass School of Massage and Therapy Inc,18,10,4,14
445267,Central Methodist University-College of Graduate and Extended Studies,4555,2667,1445,3110
176947,Central Methodist University-College of Liberal Arts and Sciences,1107,1057,1024,83
169248,Central Michigan University,26841,22364,19653,7188
187532,Central New Mexico Community College,28891,16041,9546,19345
455743,Central Nursing College,33,33,33,0
201672,Central Ohio Technical College,3648,1886,995,2653
208318,Central Oregon Community College,6760,4247,2977,3783
211477,Central Penn College,1297,897,638,659
369668,Central Pennsylvania Institute of Science and Technology,197,184,178,19
198260,Central Piedmont Community College,20198,11524,7140,13058
231688,Central School of Practical Nursing,50,29,19,31
201681,Central School of Practical Nursing,123,123,123,0
206932,Central State Beauty Academy,104,82,67,37
446145,Central State Massage Academy,36,31,28,8
201690,Central State University,2068,1931,1840,228
406422,Central Susquehanna Intermediate Unit LPN Career,92,70,59,33
246017,Central Technology Center,279,217,186,93
246460,Central Texas Beauty College-Round Rock,80,80,80,0
383464,Central Texas Beauty College-Temple,132,132,132,0
223816,Central Texas College,21647,9761,3754,17893
231697,Central Virginia Community College,4730,2561,1465,3265
234827,Central Washington University,11287,10179,9458,1829
240514,Central Wyoming College,2182,1285,831,1351
189857,Central Yeshiva Tomchei Tmimim Lubavitz,731,731,731,0
234845,Centralia College,3453,2471,1806,1647
156408,Centre College,1381,1379,1378,3
451741,Centro de Estudios Multidisciplinarios-Bayamon,631,583,552,79
376224,Centro de Estudios Multidisciplinarios-Humacao,743,687,651,92
241517,Centro de Estudios Multidisciplinarios-San Juan,987,970,959,28
451592,Centura College-Alexandria,7,5,3,4
420024,Centura College-Chesapeake,166,139,122,44
444972,Centura College-Columbia,64,44,31,33
377449,Centura College-Newport News,138,107,86,52
377458,Centura College-Norfolk,260,206,170,90
434812,Centura College-North Charleston,43,22,9,34
427982,Centura College-Richmond Main,229,177,142,87
232016,Centura College-Virginia Beach,477,351,270,207
446446,Centura Institute,45,30,20,25
436553,Century College,225,225,225,0
175315,Century College,10073,6029,3985,6088
111887,Cerritos College,21404,11808,6958,14446
111896,Cerro Coso Community College,4523,2146,944,3579
444510,CES College,166,155,148,18
427894,CET-Alexandria,169,89,36,133
146791,CET-Chicago,209,209,209,0
381255,CET-Coachella,187,113,64,123
427919,CET-Durham,134,102,81,53
111726,CET-El Centro,234,234,234,0
432269,CET-El Paso,99,99,99,0
111771,CET-Gilroy,104,104,104,0
381282,CET-Oxnard,133,120,111,22
381334,CET-Rancho Temecula,72,45,28,44
430342,CET-Sacramento,145,145,145,0
111799,CET-Salinas,65,65,65,0
111744,CET-San Bernardino,103,103,103,0
111708,CET-San Diego,267,201,158,109
381325,CET-Santa Maria,155,125,105,50
111717,CET-Sobrato,345,332,324,21
468769,CET-Soledad,97,97,97,0
111762,CET-Watsonville,88,88,88,0
111920,Chabot College,13142,7029,3939,9203
180948,Chadron State College,3056,2353,1912,1144
111939,Chaffey College,19211,10212,5664,13547
454245,Chamberlain College of Nursing-Arizona,515,389,307,208
457129,Chamberlain College of Nursing-Florida,649,461,339,310
475732,Chamberlain College of Nursing-Georgia,613,487,405,208
454227,Chamberlain College of Nursing-Illinois,13720,6871,2489,11231
475741,Chamberlain College of Nursing-Indiana,159,132,114,45
466921,Chamberlain College of Nursing-Missouri,488,360,278,210
454236,Chamberlain College of Nursing-Ohio,667,472,346,321
466930,Chamberlain College of Nursing-Texas,258,202,165,93
460871,Chamberlain College of Nursing-Virginia,364,282,229,135
446996,Chambersburg Beauty School,64,56,51,13
141486,Chaminade University of Honolulu,2752,2368,2124,628
449782,Champion Beauty College,70,49,36,34
422190,Champion Institute of Cosmetology,74,35,9,65
230852,Champlain College,3305,2897,2635,670
364025,Chandler-Gilbert Community College,14399,7802,4467,9932
111948,Chapman University,7892,7387,7071,821
123493,Charles A Jones Career and Education Center,1032,924,869,163
223852,Charles and Sues School of Hair Design,19,19,19,0
419095,Charles H McCann Technical School,49,49,49,0
104391,Charles of Italy Beauty College,83,83,83,0
111966,Charles R Drew University of Medicine and Science,515,438,390,125
418171,Charles Stuart School of Diamond Setting,37,37,37,0
217794,Charleston Cosmetology Institute,106,95,87,19
237303,Charleston School of Beauty Culture,121,121,121,0
451510,Charleston School of Law,542,471,427,115
217688,Charleston Southern University,3269,2897,2661,608
443951,Charlie's Guard-Detective Bureau and Academy Inc,96,96,96,0
455169,Charlotte School of Law,1410,1244,1141,269
132976,Charlotte Technical Center,567,340,225,342
102845,Charter College-Anchorage,2191,2191,2191,0
434317,Charter College-Canyon Country,1317,1317,1317,0
128780,Charter Oak State College,1580,817,301,1279
217828,Charzanne Beauty College,59,49,42,17
201751,Chatfield College,427,298,213,214
211556,Chatham University,2170,1752,1488,682
140331,Chattahoochee Technical College,10470,5796,3434,7036
101028,Chattahoochee Valley Community College,1837,1316,1053,784
220118,Chattanooga College Medical Dental and Technical Careers,345,345,345,0
219824,Chattanooga State Community College,9910,6259,4414,5496
240709,Cheeks International Academy of Beauty Culture-Cheyenne,46,39,34,12
381699,Cheeks International Academy of Beauty Culture-Fort Collins,34,27,22,12
381705,Cheeks International Academy of Beauty Culture-Greeley,39,30,24,15
208390,Chemeketa Community College,12111,8123,6107,6004
189954,Cheryl Fells School of Business,56,56,56,0
162168,Chesapeake College,2563,1428,854,1709
418427,Chester County Intermediate Unit,156,142,135,21
211583,Chestnut Hill College,2189,1731,1442,747
417798,Cheveux School of Hair Design,34,34,34,0
211608,Cheyney University of Pennsylvania,1212,1158,1123,89
393180,Chicago ORT Technical Institute,425,425,425,0
475440,Chicago School for Piano Technology,9,9,9,0
144005,Chicago State University,5701,4416,3590,2111
144014,Chicago Theological Seminary,251,183,141,110
180160,Chief Dull Knife College,201,153,128,73
176992,Chillicothe Beauty Academy Inc,12,12,12,0
133021,Chipola College,2160,1434,942,1218
240116,Chippewa Valley Technical College,5617,3510,2445,3172
375656,Chisholm Trail Technology Center,164,99,66,98
201803,Choffin Career  and Technical Center,154,121,105,49
433068,CHOICE High School and Technical Center,349,304,282,67
198303,Chowan University,1367,1317,1285,82
175494,Chris Beauty College,97,97,97,0
189981,Christ the King Seminary,96,50,22,74
219833,Christian Brothers University,1577,1305,1135,442
260947,Christian Life College,41,29,22,19
150215,Christian Theological Seminary,188,152,129,59
475510,Christie's Education,73,45,28,45
475468,Christine Valmy International School of Esthetics & Cosmetology,135,114,100,35
231712,Christopher Newport University,5232,5132,5066,166
481526,Chrysm Institute of Esthetics,96,69,51,45
112127,Church Divinity School of the Pacific,79,58,45,34
201858,Cincinnati Christian University,918,794,716,202
201867,Cincinnati College of Mortuary Science,81,81,81,0
201928,Cincinnati State Technical and Community College,11167,6511,4157,7010
461829,Cinta Aveda Institute,221,221,221,0
190008,Circle in the Square Theater School,78,78,78,0
223898,Cisco College,3617,2279,1603,2014
217864,Citadel Military College of South Carolina,3598,3014,2668,930
211635,Citizens School of Nursing,181,181,181,0
112172,Citrus College,12920,7613,4931,7989
112181,Citrus Heights Beauty College,96,92,89,7
112190,City College of San Francisco,26706,15076,9198,17508
417327,City College-Altamonte Springs,425,350,300,125
244233,City College-Fort Lauderdale,633,483,386,247
406547,City College-Gainesville,444,381,341,103
475477,City College-Hollywood,126,91,68,58
434539,City College-Miami,283,237,207,76
144209,City Colleges of Chicago-Harold Washington College,9036,7058,6059,2977
144184,City Colleges of Chicago-Harry S Truman College,11800,6001,3070,8730
144157,City Colleges of Chicago-Kennedy-King College,5860,4151,3287,2573
144166,City Colleges of Chicago-Malcolm X College,6842,4321,3047,3795
144175,City Colleges of Chicago-Olive-Harvey College,5298,3067,1940,3358
144193,City Colleges of Chicago-Richard J Daley College,9384,5648,3760,5624
144218,City Colleges of Chicago-Wilbur Wright College,12640,7158,4387,8253
481517,City Pointe Beauty Academy,49,49,49,0
234915,City University of Seattle,2368,1756,1367,1001
457697,City Vision College,78,59,47,31
208406,Clackamas Community College,7368,4359,2838,4530
217873,Claflin University,1884,1837,1807,77
112251,Claremont Graduate University,2204,1789,1532,672
112260,Claremont McKenna College,1328,1326,1324,4
124283,Claremont School of Theology,272,177,118,154
206969,Claremore Beauty College,17,17,17,0
223922,Clarendon College,1214,790,576,638
418603,Clarion County Career Center Practical Nursing Program,35,20,13,22
211644,Clarion University of Pennsylvania,6080,5157,4580,1500
138947,Clark Atlanta University,3458,3203,3044,414
234933,Clark College,11462,7592,5636,5826
201973,Clark State Community College,5653,3023,1693,3960
165334,Clark University,3551,3306,3153,398
153126,Clarke University,1225,1096,1014,211
237321,Clarksburg Beauty Academy and School of Massage Therapy,70,70,70,0
180832,Clarkson College,1238,765,467,771
190044,Clarkson University,3726,3650,3602,124
450401,Clary Sage College,312,312,312,0
476656,Classic Cooking Academy,9,9,9,0
208415,Clatsop Community College,1069,661,455,614
139311,Clayton  State University,7261,5362,4092,3169
156417,Clear Creek Baptist Bible College,152,122,103,49
430908,Clearfield County Career and Technology Center,67,56,50,17
133085,Clearwater Christian College,505,489,479,26
169327,Cleary University,546,417,333,213
217882,Clemson University,21303,19846,18963,2340
411754,Cleveland Clinic Health System-School of Diagnostic Imaging,44,44,44,0
198321,Cleveland Community College,3371,1912,1175,2196
202046,Cleveland Institute of Art,568,562,558,10
202055,Cleveland Institute of Dental-Medical Assistants-Cleveland,113,113,113,0
375319,Cleveland Institute of Dental-Medical Assistants-Lyndhurst,64,64,64,0
375300,Cleveland Institute of Dental-Medical Assistants-Mentor,135,135,135,0
202073,Cleveland Institute of Music,451,447,445,6
219879,Cleveland State Community College,3790,2525,1885,1905
202134,Cleveland State University,17497,13369,10825,6672
177038,Cleveland University-Kansas City,500,489,482,18
217891,Clinton College,185,183,182,3
190053,Clinton Community College,1990,1393,1092,898
417868,Clinton Essex Warren Washington BOCES-Practical Nursing Program,22,22,22,0
260336,Clinton Technical School,23,23,23,0
154907,Cloud County Community College,2318,1365,883,1435
234951,Clover Park Technical College,3720,2815,2358,1362
112367,Clovis Adult Education,608,447,366,242
187639,Clovis Community College,3596,1808,905,2691
366155,Cloyd's Barber School 2 Inc,27,27,27,0
158538,Cloyd's Beauty School 1 Inc,51,51,51,0
248527,Cloyd's Beauty School 3 Inc,44,44,44,0
449393,Coachella Valley Beauty College,129,129,129,0
175519,Coahoma Community College,2073,1928,1854,219
401339,Coast Career Institute,169,169,169,0
470302,Coast Career Institute,92,92,92,0
223320,Coastal Bend College,3533,2099,1374,2159
198330,Coastal Carolina Community College,4433,2971,2232,2201
218724,Coastal Carolina University,9478,8697,8199,1279
450988,Coastline Beauty College,197,142,106,91
112385,Coastline Community College,10378,4465,1476,8902
112455,COBA Academy,40,40,40,0
417406,Cobb Beauty College Inc,58,58,58,0
104425,Cochise College,4453,2590,1649,2804
190071,Cochran School of Nursing,79,37,10,69
404426,Coconino Community College,3694,1910,1009,2685
153144,Coe College,1419,1378,1351,68
154925,Coffeyville Community College,1866,1339,1072,794
112394,Cogswell College,472,381,322,150
217907,Coker College,1172,1073,1010,162
161086,Colby College,1820,1820,1820,0
154934,Colby Community College,1402,898,643,759
182634,Colby-Sawyer College,1409,1395,1386,23
430935,Colegio de Cinematografía Artes y Television,867,737,651,216
443100,Colegio Educativo Tecnologico Industrial Inc,188,188,188,0
376242,Colegio Mayor de Tecnologia Inc,87,87,87,0
445498,Colegio Tecnico de Electricidad Galloza,76,76,76,0
418755,Colegio Tecnologico y Comercial de Puerto Rico,118,118,118,0
241720,Colegio Universitario de San Juan,1387,1258,1171,216
112446,Coleman University,833,773,734,99
190080,Colgate Rochester Crozer Divinity School,87,70,59,28
190099,Colgate University,2900,2886,2877,23
420608,Colleen O'Haras Beauty Academy,155,149,145,10
451705,College America-Cheyenne,75,75,75,0
448752,College America-Colorado Springs,322,322,322,0
126872,College America-Denver,497,497,497,0
103945,College America-Flagstaff,209,209,209,0
448761,College America-Fort Collins,159,159,159,0
474890,College America-Phoenix,451,451,451,0
169442,College for Creative Studies,1423,1250,1138,285
108667,College of Alameda,5799,2423,716,5083
388520,College of Biblical Studies-Houston,498,241,74,424
449083,College of Business and Technology-Flagler,323,323,323,0
449092,College of Business and Technology-Hialeah,178,178,178,0
417318,College of Business and Technology-Kendall,127,127,127,0
482024,College of Business and Technology-Miami Gardens,54,54,54,0
132851,College of Central Florida,8162,5112,3048,5114
217819,College of Charleston,11619,10632,10022,1597
139250,College of Coastal Georgia,2987,2302,1838,1149
210340,College of Cosmetology,93,93,93,0
150251,College of Court Reporting Inc,265,155,83,182
144865,College of DuPage,28627,16193,9908,18719
154545,College of Hair Design,46,46,46,0
208433,College of Hair Design Careers,68,68,68,0
180957,College of Hair Design-Downtown,116,116,116,0
456287,College of Hair Design-East Campus,114,114,114,0
392257,College of Health Care Professions-Northwest,810,810,810,0
476586,College of International Esthetics Inc,75,59,48,27
146472,College of Lake County,17685,9102,4764,12921
118347,College of Marin,6077,2891,1281,4796
460808,College of Massage Therapy,12,12,12,0
413617,College of Menominee Nation,661,391,217,444
243638,College of Micronesia-FSM,2446,1904,1630,816
193399,College of Mount Saint Vincent,1938,1693,1539,399
204200,College of Mount St Joseph,2326,1780,1432,894
167394,College of Our Lady of the Elms,1678,1276,1021,657
174747,College of Saint Benedict,2051,2029,2015,36
186618,College of Saint Elizabeth,1552,1028,697,855
181604,College of Saint Mary,970,852,777,193
122791,College of San Mateo,9377,4823,2521,6856
142559,College of Southern Idaho,8330,4610,2730,5600
162122,College of Southern Maryland,8781,5151,3317,5464
182005,College of Southern Nevada,34177,19102,8903,25274
231077,College of St Joseph,271,192,142,129
190558,College of Staten Island CUNY,14441,11697,9900,4541
197814,College of the Albemarle,2607,1652,1170,1437
160959,College of the Atlantic,370,358,351,19
111461,College of the Canyons,18508,10496,6446,12062
113573,College of the Desert,9259,5519,3629,5630
166124,College of the Holy Cross,2912,2891,2877,35
226408,College of the Mainland,4188,2151,1121,3067
376695,College of the Marshall Islands,1000,783,673,327
480967,College of the Muscogee Nation,191,133,103,88
107521,College of the Ouachitas,1501,892,584,917
178697,College of the Ozarks,1513,1504,1498,15
121707,College of the Redwoods,4938,2921,1901,3037
123217,College of the Sequoias,10720,6873,4928,5792
123484,College of the Siskiyous,2533,1516,1002,1531
455114,College of Western Idaho,9191,5698,3933,5258
231624,College of William and Mary,8376,8043,7850,526
199078,College of Wilmington,182,182,182,0
476319,CollegeAmerica-Colorado Springs South,31,31,31,0
474906,CollegeAmerica-Stevens Henager College,95,95,95,0
247834,Collin County Community College District,27972,15721,9529,18443
103723,Collins College,254,225,206,48
156444,Collins School of Cosmetology,29,29,29,0
461953,Colorado Academy of Veterinary Technology,92,91,91,1
126669,Colorado Christian University,5368,3067,1583,3785
126678,Colorado College,2061,2051,2044,17
367839,Colorado Heights University,375,359,349,26
443632,Colorado Media School,187,187,187,0
127556,Colorado Mesa University,9676,8246,7284,2392
126711,Colorado Mountain College,5893,3565,1990,3903
126748,Colorado Northwestern Community College,1138,708,490,648
381732,Colorado School of Healing Arts,201,152,119,82
126775,Colorado School of Mines,5790,5415,5188,602
126784,Colorado School of Trades,182,182,182,0
381352,Colorado School of Traditional Chinese Medicine,136,123,115,21
126818,Colorado State University-Fort Collins,31186,26329,23371,7815
476975,Colorado State University-Global Campus,7402,4785,3092,4310
128106,Colorado State University-Pueblo,7089,5211,4051,3038
126827,Colorado Technical University-Colorado Springs,2049,1589,1296,753
430087,Colorado Technical University-Greenwood Village,869,614,451,418
409838,Colorado Technical University-Kansas City,45,36,31,14
444158,Colorado Technical University-Online,20826,15938,12777,8049
402615,Colorado Technical University-Sioux Falls,276,196,144,132
395195,Colton-Redlands-Yucaipa Regional Occupational Program,101,101,101,0
475626,Columbia Academy of Cosmetology,37,35,34,3
177056,Columbia Area Career Center,78,55,44,34
234979,Columbia Basin College,6480,4818,3693,2787
241304,Columbia Centro Universitario-Caguas,1823,1211,817,1006
404806,Columbia Centro Universitario-Yauco,402,293,223,179
177065,Columbia College,16946,12460,9572,7374
112561,Columbia College,2626,1442,843,1783
217934,Columbia College,1169,985,867,302
455983,Columbia College,310,283,266,44
479248,Columbia College,147,135,127,20
238573,Columbia College of Nursing,157,148,142,15
144281,Columbia College-Chicago,10142,9487,9066,1076
112570,Columbia College-Hollywood,314,296,285,29
420556,Columbia Gorge Community College,974,548,332,642
480693,Columbia Institute,45,43,42,3
217925,Columbia International University,1154,908,754,400
450933,Columbia Southern University,20185,15437,12365,7820
219888,Columbia State Community College,5225,3258,2264,2961
139348,Columbia Theological Seminary,233,181,149,84
190150,Columbia University in the City of New York,26957,24352,22731,4226
190169,Columbia-Greene Community College,2118,1351,964,1154
202152,Columbiana County Career and Technical Center,190,166,154,36
202170,Columbus College of Art and Design,1379,1306,1258,121
202222,Columbus State Community College,25249,14334,8817,16432
139366,Columbus State University,8156,6470,5382,2774
139357,Columbus Technical College,3739,2203,1426,2313
366261,Commonwealth Institute of Funeral Service,219,208,200,19
212975,Commonwealth Technical Institute,206,204,203,3
439570,Community Care College,587,587,587,0
446163,Community Christian College,60,49,42,18
210605,Community College of Allegheny County,18229,10316,6317,11912
126863,Community College of Aurora,7874,3730,1636,6238
211079,Community College of Beaver County,2335,1458,1014,1321
126942,Community College of Denver,10432,5107,2415,8017
215239,Community College of Philadelphia,19063,9771,5075,13988
217475,Community College of Rhode Island,17699,9568,5459,12240
230861,Community College of Vermont,6200,2724,967,5233
369109,Community Services Division-Alliance City,106,67,47,59
447962,Compass Career College,162,162,162,0
459417,Compass College of Cinematic Arts,81,81,81,0
423120,Compu-Med Vocational Careers Corp,920,920,920,0
427025,Computer Systems Institute,2154,2154,2154,0
444529,Computer Tutor Business and Technical Institute,121,121,121,0
144573,Concept College of Cosmetology,58,58,58,0
143181,Concept College of Cosmetology,33,33,33,0
177083,Conception Seminary College,99,94,90,9
237330,Concord University,2767,2503,2339,428
126687,Concorde Career College-Aurora,847,847,847,0
123679,Concorde Career College-Garden Grove,898,898,898,0
441742,Concorde Career College-Grand Prairie,785,785,785,0
219903,Concorde Career College-Memphis,1313,1313,1313,0
124937,Concorde Career College-North Hollywood,925,925,925,0
208479,Concorde Career College-Portland,925,925,925,0
124706,Concorde Career College-San Bernardino,753,753,753,0
120661,Concorde Career College-San Diego,895,895,895,0
155283,Concorde Career Colleges,783,783,783,0
460181,Concorde Career Institute-Dallas,703,703,703,0
133845,Concorde Career Institute-Jacksonville,630,630,630,0
133854,Concorde Career Institute-Miramar,508,508,508,0
460190,Concorde Career Institute-Orlando,521,521,521,0
460206,Concorde Career Institute-San Antonio,681,681,681,0
133863,Concorde Career Institute-Tampa,454,454,454,0
101073,Concordia College Alabama,600,565,543,57
173300,Concordia College at Moorhead,2558,2515,2488,70
190248,Concordia College-New York,953,901,868,85
177092,Concordia Seminary,376,274,211,165
150288,Concordia Theological Seminary,301,263,239,62
169363,Concordia University-Ann Arbor,740,612,532,208
144351,Concordia University-Chicago,5286,3061,1684,3602
112075,Concordia University-Irvine,4046,3615,3345,701
180984,Concordia University-Nebraska,2206,1913,1725,481
208488,Concordia University-Portland,5428,5141,4960,468
173328,Concordia University-Saint Paul,3661,2951,2494,1167
224004,Concordia University-Texas,2565,1692,1145,1420
238616,Concordia University-Wisconsin,7943,5938,4676,3267
211802,Conemaugh Valley Memorial Hospital,231,221,214,17
224013,Conlee's College of Cosmetology,51,40,32,19
443483,Connecticut Center for Massage Therapy-Groton,157,76,22,135
128896,Connecticut Center for Massage Therapy-Newington,304,161,67,237
407054,Connecticut Center for Massage Therapy-Westport,158,74,19,139
128902,Connecticut College,1922,1897,1881,41
365569,Connecticut Institute of Hair Design,28,21,16,12
206996,Connors State College,2397,1784,1474,923
262341,Conservatory of Recording Arts and Sciences,693,693,693,0
260354,Consolidated School of Business-Lancaster,112,109,107,5
211820,Consolidated School of Business-York,107,105,103,4
182652,Continental Academie of Hair Design-Hudson,62,62,62,0
190309,Continental School of Beauty Culture-Batavia,36,36,36,0
190293,Continental School of Beauty Culture-Buffalo,124,99,83,41
467094,Continental School of Beauty Culture-Mattydale,272,190,136,136
374990,Continental School of Beauty Culture-Olean,78,62,51,27
190318,Continental School of Beauty Culture-Rochester,332,257,208,124
194435,Continental School of Beauty Culture-West Seneca,111,86,70,41
112826,Contra Costa College,6865,3735,2153,4712
217961,Converse College,1333,989,775,558
165495,Conway School of Landscape Design,16,16,16,0
184153,Cooper Health System Center for Allied Health Education,53,52,52,1
190372,Cooper Union for the Advancement of Science and Art,920,910,903,17
175573,Copiah-Lincoln Community College,3157,2727,2509,648
395362,Copper Mountain Community College,1783,1097,750,1033
162283,Coppin State University,3383,2773,2384,999
210331,Corban University,1143,1004,916,227
131308,Corcoran College of Art and Design,548,434,362,186
451343,Corinth Academy of Cosmetology,160,131,112,48
153162,Cornell College,1125,1120,1117,8
190415,Cornell University,21593,21553,21528,65
170037,Cornerstone University,2809,2259,1909,900
190442,Corning Community College,4929,3232,2375,2554
235024,Cornish College of the Arts,778,762,752,26
166975,Cortiva Institute-Boston,210,135,85,125
244561,Cortiva Institute-Chicago,472,241,89,383
134574,Cortiva Institute-Florida,173,134,108,65
460640,Cortiva Institute-New Jersey,66,48,36,30
215044,Cortiva Institute-Pennsylvania School of Muscle Therapy,112,84,66,46
105482,Cortiva Institute-Scottsdale,87,63,48,39
479053,Cortiva Institute-Seattle,102,68,46,56
419411,Cortiva Institute-Seattle,219,165,129,90
104504,Cortiva Institute-Tucson,143,115,96,47
461360,Cosmetic Arts Institute,34,33,33,1
144795,Cosmetology & Spa Academy,147,140,136,11
482200,Cosmetology Academy of Texarkana,20,20,20,0
224156,Cosmetology Career Center LLC,215,215,215,0
434502,Cosmetology Career Institute,129,129,129,0
173726,Cosmetology Careers Unlimited College of Hair Skin and Nails,37,37,37,0
173470,Cosmetology Careers Unlimited College of Hair Skin and Nails,33,33,33,0
461537,Cosmetology College of Franklin County,25,25,25,0
177685,Cosmetology Concepts Institute,38,38,38,0
445780,Cosmetology School of Arts and Sciences,32,32,32,0
414559,Cosmetology Schools Inc,18,18,18,0
407142,Cosmetology Training Center,109,109,109,0
459189,Cosmo Beauty Academy,64,41,26,38
481395,Cosmo Factory Cosmetology Academy,30,28,27,3
461449,Cosmopolitan Beauty and Tech School,110,89,75,35
481359,Cosmotech School of Cosmetology,45,41,39,6
106795,Cossatot Community College of the University of Arkansas,1597,969,652,945
113096,Cosumnes River College,13949,6897,3333,10616
177117,Cottey College,277,276,275,2
184180,County College of Morris,8447,5858,4549,3898
224183,Court Reporting Institute of Dallas,183,80,13,170
444547,Court Reporting Institute of Louisiana,31,26,23,8
481766,Court Reporting Institute of St Louis,161,95,52,109
139393,Covenant College,1173,1130,1102,71
226675,Covenant School of Nursing and Allied Health,310,310,310,0
177126,Covenant Theological Seminary,602,389,257,345
154952,Cowley County Community College,3888,2681,2071,1817
176770,Cox College,880,622,455,425
144485,Coyne College,590,590,590,0
454874,Cozmo The School,55,48,44,11
113111,Crafton Hills College,5697,3235,1991,3706
169424,Cranbrook Academy of Art,149,149,149,0
198367,Craven Community College,3376,2071,1412,1964
419484,Crawford County Career and Technical Center Practical Nursing Program,31,31,31,0
175591,Creations College of Cosmetology,51,51,51,0
434830,Creative Images Institute of Cosmetology-North Dayton,181,140,113,68
444051,Creative Images Institute of Cosmetology-South Dayton,99,82,71,28
181002,Creighton University,8019,7214,6711,1308
158617,Crescent City Bartending School,469,469,469,0
180090,Crevier's School of Cosmetology,83,83,83,0
413680,Crimson Technical College,458,458,458,0
475608,Criswell College,323,231,173,150
446190,Crossett School of Cosmetology,27,27,27,0
439613,Crossroads Bible College,257,185,139,118
174206,Crossroads College,101,93,88,13
190451,Crouse Hospital College of Nursing,336,224,150,186
177135,Crowder College,5845,3664,2561,3284
106810,Crowley's Ridge College,200,165,143,57
106829,Crowley's Ridge Technical Institute,286,267,258,28
174862,Crown College,1323,1169,1071,252
371830,CRU Institute,55,41,31,24
113193,Cuesta College,9256,5656,3837,5419
444565,Culinary Institute Inc,374,224,126,248
190503,Culinary Institute of America,2814,2814,2814,0
446206,Culpeper Cosmetology Training Center,33,28,26,7
177144,Culver-Stockton College,843,808,785,58
184205,Cumberland County College,3919,2867,2335,1584
219949,Cumberland University,1501,1255,1099,402
190512,CUNY Bernard M Baruch College,17505,13649,11222,6283
190521,CUNY Borough of Manhattan Community College,24186,18675,15889,8297
190530,CUNY Bronx Community College,11368,8199,6598,4770
190549,CUNY Brooklyn College,17004,12742,10061,6943
190567,CUNY City College,15331,11885,9721,5610
190576,CUNY Graduate School and University Center,6736,5323,4454,2282
190585,CUNY Hostos Community College,7006,5026,4026,2980
190594,CUNY Hunter College,23019,16886,13087,9932
190600,CUNY John Jay College of Criminal Justice,15010,12419,10764,4246
190619,CUNY Kingsborough Community College,18634,13386,10734,7900
190628,CUNY LaGuardia Community College,19564,13513,10455,9109
190637,CUNY Lehman College,12085,8325,5916,6169
190646,CUNY Medgar Evers College,6477,5159,4267,2210
190655,CUNY New York City College of Technology,16860,12958,10318,6542
190664,CUNY Queens College,18974,14235,11249,7725
190673,CUNY Queensborough Community College,16291,11864,9626,6665
190682,CUNY School of Law at Queens College,383,381,380,3
190691,CUNY York College,8307,6453,5199,3108
165529,Curry College,3074,2484,2106,968
211893,Curtis Institute of Music,168,168,168,0
476674,Curve Metric School of Hair Design,65,65,65,0
455293,Cutter's Edge School of Cosmetology,12,12,12,0
202356,Cuyahoga Community College District,27910,15698,9526,18384
204981,Cuyahoga Valley Career Center,106,63,42,64
113218,Cuyamaca College,8859,4369,2099,6760
190707,CVPH Medical Center School of Radiologic Technology,23,23,23,0
480888,CyberTex Institute of Technology,217,217,217,0
113236,Cypress College,15881,8706,5079,10802
457493,D & L Academy of Hair Design,25,25,25,0
461306,D A Dorsey Educational Center,138,91,67,71
369419,D G Erwin Technical Center,840,840,840,0
158644,D'Jay's School of Beauty Arts and Sciences,63,58,55,8
418773,D'Mart Institute,1550,1393,1289,261
190716,D'Youville College,3150,2692,2401,749
231873,Dabney S Lancaster Community College,1312,727,432,880
458797,Dade Medical College-Hollywood,303,303,303,0
458247,Dade Medical College-Homestead,309,309,309,0
476391,Dade Medical College-Jacksonville,191,191,191,0
444574,Dade Medical College-Miami,1083,1083,1083,0
454175,Dade Medical College-Miami Lakes,607,607,607,0
476382,Dade Medical College-West Palm Beach,259,259,259,0
190725,Daemen College,2871,2480,2231,640
200314,Dakota College at Bottineau,793,510,367,426
173416,Dakota County Technical College,3128,2044,1496,1632
219082,Dakota State University,3129,1996,1244,1885
219091,Dakota Wesleyan University,879,778,714,165
224226,Dallas Baptist University,5422,4006,3113,2309
443021,Dallas Barber & Stylist College,158,158,158,0
224244,Dallas Christian College,316,263,229,87
417743,Dallas County Technical Center,4,4,4,0
224271,Dallas Institute of Funeral Service,114,114,114,0
437732,Dallas Nursing Institute,169,118,84,85
224305,Dallas Theological Seminary,2111,1363,901,1210
139463,Dalton State College,5015,3839,3044,1971
383507,Dance Theatre of Harlem Inc,11,11,11,0
182661,Daniel Webster College,764,715,684,80
144564,Danville Area Community College,4035,2135,1175,2860
231882,Danville Community College,4280,2460,1540,2740
232724,Danville Regional Medical Center School of Health Professions,23,23,23,0
455178,Daoist Traditions College of Chinese Medical Arts,78,76,75,3
182670,Dartmouth College,6342,6246,6185,157
138691,Darton State College,6195,4041,2953,3242
169479,Davenport University,9591,5370,2676,6915
169503,David Pressley School of Cosmetology,225,225,225,0
442204,David's Academy of Beauty,199,192,187,12
452692,David-Curtis School of Floral Design,2,2,2,0
198385,Davidson College,1788,1788,1788,0
198376,Davidson County Community College,4073,2683,1980,2093
237358,Davis & Elkins College,874,858,847,27
230162,Davis Applied Technology College,2769,1238,464,2305
202435,Davis College,218,119,53,165
194569,Davis College,395,295,231,164
130873,Dawn Career Institute Inc,638,638,638,0
180151,Dawson Community College,372,276,227,145
446215,Day Spa Career College,44,44,44,0
447476,Daymar College-Bellevue,97,88,83,14
363439,Daymar College-Bowling Green,255,212,185,70
205568,Daymar College-Chillicothe,76,68,63,13
205531,Daymar College-Jackson,77,66,59,18
205559,Daymar College-Lancaster,69,65,63,6
460473,Daymar College-Louisville,15,12,10,5
406219,Daymar College-Louisville,189,151,126,63
449302,Daymar College-Madisonville,33,29,26,7
205522,Daymar College-New Boston,87,77,71,16
458557,Daymar College-Online,368,309,271,97
157465,Daymar College-Owensboro,122,93,75,47
156903,Daymar College-Paducah Main,86,74,67,19
455646,Daymar College-Scottsville,48,41,36,12
368443,Daymar Institute-Clarksville,497,458,433,64
444255,Daymar Institute-Murfreesboro,190,169,156,34
220002,Daymar Institute-Nashville,141,121,108,33
202453,Dayton Barber College,57,51,47,10
449700,Dayton School of Medical Massage,505,505,505,0
447014,Daytona College,327,327,327,0
133386,Daytona State College,14865,9670,6156,8709
406413,DCI Career Institute,107,107,107,0
113333,De Anza College,23261,14966,10774,12487
187602,De Wolff College Hair Styling and Cosmetology,86,86,86,0
165574,Dean College,1300,1164,1076,224
211909,Dean Institute of Technology,163,135,116,47
202514,Defiance College,989,853,766,223
224350,Del Mar College,10502,5551,3048,7454
407452,Delaware Area Career Center,68,65,64,4
406361,Delaware Chenango Madison Otsego BOCES-Practical Nursing Program,37,37,37,0
432524,Delaware College of Art and Design,196,188,183,13
211927,Delaware County Community College,13198,7649,4844,8354
430971,Delaware County Technical School-Practical Nursing Program,56,56,56,0
449472,Delaware Learning Institute of Cosmetology,80,80,80,0
130934,Delaware State University,4336,4087,3926,410
130891,Delaware Technical Community College-Owens,4429,2802,1980,2449
130916,Delaware Technical Community College-Stanton/Wilmington,7030,4097,2615,4415
130907,Delaware Technical Community College-Terry,3031,1977,1444,1587
211981,Delaware Valley College,2023,1814,1681,342
158662,Delgado Community College,18698,11529,7906,10792
113537,Dell'Arte International School of Physical Theatre,29,29,29,0
162335,Delmarva Beauty Academy,67,67,67,0
175607,Delta Beauty College,50,50,50,0
169521,Delta College,10272,6026,3880,6392
402563,Delta College Inc,102,102,102,0
366270,Delta College of Arts & Technology,678,678,678,0
126915,Delta Montrose Technical College,423,228,129,294
158723,Delta School of Business and Technology,199,199,199,0
175616,Delta State University,4785,4097,3676,1109
447023,Delta Technical College,648,638,631,17
158778,Demmons School of Beauty,58,58,58,0
158787,Denham Springs Beauty School,91,91,91,0
202523,Denison University,2274,2261,2253,21
217989,Denmark Technical College,1838,1557,1415,423
452771,Dental Assistant Pro LLC-Columbus,16,6,0,16
452780,Dental Assistant Pro-Lebanon,18,7,0,18
454856,Denver School of Nursing,696,696,696,0
126979,Denver Seminary,990,720,553,437
144740,DePaul University,24414,20917,18706,5708
150400,DePauw University,2304,2289,2280,24
153214,Des Moines Area Community College,20167,11909,7735,12432
154156,Des Moines University-Osteopathic Medical Center,1763,1544,1408,355
210739,DeSales University,3266,2530,2063,1203
113582,Design Institute of San Diego,181,143,119,62
441256,Design's School of Cosmetology,61,61,61,0
169576,Detroit Business Institute-Downriver,76,70,66,10
482413,DeVry College of New York,2127,1536,1162,965
482422,DeVry University-Arizona,1565,992,626,939
482431,DeVry University-California,9156,6078,4109,5047
482440,DeVry University-Colorado,1116,649,351,765
482459,DeVry University-Florida,3252,2078,1330,1922
482468,DeVry University-Georgia,3731,2230,1272,2459
482477,DeVry University-Illinois,26851,15088,7571,19280
482486,DeVry University-Indiana,467,259,127,340
482495,DeVry University-Kentucky,78,48,29,49
482501,DeVry University-Maryland,137,79,42,95
482510,DeVry University-Michigan,304,168,81,223
482529,DeVry University-Minnesota,466,260,129,337
482538,DeVry University-Missouri,1130,686,404,726
482547,DeVry University-Nevada,440,270,162,278
482556,DeVry University-New Jersey,1725,1155,790,935
482565,DeVry University-North Carolina,737,439,250,487
482574,DeVry University-Ohio,3578,2195,1310,2268
482583,DeVry University-Oklahoma,184,120,80,104
482592,DeVry University-Oregon,149,99,67,82
482608,DeVry University-Pennsylvania,1481,883,502,979
482617,DeVry University-Tennessee,452,259,136,316
482635,DeVry University-Texas,3382,2139,1347,2035
482644,DeVry University-Utah,150,81,38,112
482653,DeVry University-Virginia,1328,830,516,812
482662,DeVry University-Washington,673,430,275,398
482671,DeVry University-Wisconsin,304,168,83,221
449153,Dewey University-Arroyo,169,169,169,0
436465,Dewey University-Bayamon,307,307,307,0
434900,Dewey University-Carolina,1031,1031,1031,0
449144,Dewey University-Fajardo,188,188,188,0
469407,Dewey University-Hatillo,270,270,270,0
443562,Dewey University-Hato Rey,2565,2083,1772,793
431309,Dewey University-Hato Rey,96,96,96,0
449135,Dewey University-Juana Díaz,395,395,395,0
469416,Dewey University-Manati,274,274,274,0
469391,Dewey University-Yabucoa,2,2,2,0
113634,Diablo Valley College,20286,11919,7690,12596
476780,Diamond Beauty College,122,86,62,60
461388,Diamonds Cosmetology College,41,41,41,0
212009,Dickinson College,2396,2372,2356,40
200059,Dickinson State University,1449,1192,1018,431
373526,Diesel Driving Academy-Baton Rouge,256,256,256,0
260664,Diesel Driving Academy-Shreveport,149,149,149,0
443410,DigiPen Institute of Technology,1000,910,852,148
480028,Digital Film Academy,38,38,38,0
451060,Digital Media Arts College,300,253,222,78
451255,DiGrigoli School of Cosmetology,25,21,19,6
158802,Dillard University,1183,1150,1128,55
165608,Diman Regional Technical Institute,80,57,45,35
105297,Dine College,1466,1136,912,554
184278,Divers Academy International,236,236,236,0
235088,Divers Institute of Technology,234,234,234,0
395690,Diversified Vocational College,913,735,617,296
153241,Divine Word College,90,90,90,0
451583,Dixie Applied Technology College,165,104,73,92
230171,Dixie State University,8350,6450,5165,3185
181020,Doane College-Crete,1113,1109,1106,7
448284,Doane College-Lincoln Grand Island and Master,1653,1189,898,755
154998,Dodge City Community College,1785,1247,975,810
190761,Dominican College of Blauvelt,1998,1656,1441,557
113704,Dominican School of Philosophy & Theology,89,67,54,35
148496,Dominican University,3470,2846,2457,1013
113698,Dominican University of California,2147,1814,1603,544
451617,Dominion School of Hair Design,37,35,34,3
150437,Don Roberts Beauty School,77,52,35,42
150428,Don Roberts School of Hair Design,53,51,49,4
122117,Dongguk University-Los Angeles,179,144,123,56
475389,Donna's Academy of Hair Design,42,42,42,0
155007,Donnelly College,474,351,271,203
153250,Dordt College,1430,1378,1345,85
193380,Dorothea Hopfer School of Nursing-Mt Vernon Hospital,130,53,3,127
455549,Dorsey Business Schools-Farmington Hills,97,97,97,0
481599,Dorsey Business Schools-Lansing,156,156,156,0
169734,Dorsey Business Schools-Madison Heights,203,203,203,0
250744,Dorsey Business Schools-Roseville,515,515,515,0
455558,Dorsey Business Schools-Roseville Culinary Academy,165,165,165,0
460482,Dorsey Business Schools-Saginaw,223,223,223,0
169761,Dorsey Business Schools-Southgate,145,145,145,0
458380,Dorsey Business Schools-Waterford Pontiac,229,229,229,0
247153,Dorsey Business Schools-Wayne,191,191,191,0
212045,Douglas Education Center,274,269,266,8
261436,Douglas J Aveda Institute,977,977,977,0
190770,Dowling College,3198,2304,1737,1461
371690,Downey Adult School,1317,827,579,738
449481,Dragon Rises College of Oriental Medicine,56,56,56,0
184320,Drake College of Business-Elizabeth,1133,1133,1133,0
458414,Drake College of Business-Newark,1335,1335,1335,0
153269,Drake University,5139,4511,4120,1019
184348,Drew University,2291,1982,1790,501
212054,Drexel University,26132,21697,18909,7223
177214,Drury University,4649,3815,3278,1371
212072,Du Bois Business College-Du Bois,122,115,110,12
439303,Du Bois Business College-Huntingdon,88,80,75,13
439312,Du Bois Business College-Oil City,40,33,29,11
184357,duCret School of Arts,32,24,19,13
198419,Duke University,15467,15113,14894,573
173489,Duluth Business University,201,146,111,90
175227,Dunwoody College of Technology,1071,940,855,216
212106,Duquesne University,9904,9353,9008,896
417804,Durham Beauty Academy,70,70,70,0
198455,Durham Technical Community College,5605,2958,1620,3985
431105,Dutchess BOCES-Practical Nursing Program,151,70,29,122
190840,Dutchess Community College,10232,6685,4893,5339
458043,DuVall's School of Cosmetology,91,82,76,15
220057,Dyersburg State Community College,3258,1952,1292,1966
154466,E Q School of Hair Design,68,68,68,0
447421,Eagle Gate College-Layton,241,172,127,114
230366,Eagle Gate College-Murray,290,206,152,138
447625,Eagle Gate College-Salt Lake City,186,115,69,117
150455,Earlham College,1159,1122,1099,60
106883,East Arkansas Community College,1386,871,610,776
198464,East Carolina University,26887,23237,20971,5916
177250,East Central College,3900,2540,1852,2048
175643,East Central Community College,2572,2175,1974,598
207041,East Central University,4587,3812,3327,1260
139621,East Georgia State College,2857,2462,2194,663
113856,East Los Angeles College,36606,17000,7090,29516
175652,East Mississippi Community College,4364,3257,2697,1667
413802,East San Gabriel Valley Regional Occupational Program,983,550,331,652
212115,East Stroudsburg University of Pennsylvania,6778,6179,5794,984
220075,East Tennessee State University,14691,12791,11577,3114
224527,East Texas Baptist University,1247,1149,1086,161
441210,East Valley Institute of Technology,343,221,160,183
439394,East West College of Natural Medicine,125,125,125,0
208637,East West College of the Healing Arts,246,98,0,246
144883,East-West University,684,675,669,15
104577,Eastern Arizona College,6602,3514,1953,4649
375966,Eastern Center for Arts and Technology,142,90,63,79
106892,Eastern College of Health Vocations-Little Rock,302,302,302,0
364751,Eastern College of Health Vocations-New Orleans,221,221,221,0
129215,Eastern Connecticut State University,5368,4823,4462,906
132693,Eastern Florida State College,16711,10280,5929,10782
203331,Eastern Gateway Community College,2929,1923,1414,1515
202639,Eastern Hills Academy of Hair Design,71,50,37,34
142179,Eastern Idaho Technical College,725,439,294,431
144892,Eastern Illinois University,9775,8693,8013,1762
448354,Eastern International College-Belleville,216,175,148,68
421878,Eastern International College-Jersey City,222,192,173,49
153311,Eastern Iowa Community College District,8694,4595,2524,6170
156620,Eastern Kentucky University,16111,13386,11651,4460
161138,Eastern Maine Community College,2558,1759,1355,1203
232043,Eastern Mennonite University,1640,1401,1252,388
169798,Eastern Michigan University,23447,17968,14493,8954
165644,Eastern Nazarene College,1478,1436,1409,69
187648,Eastern New Mexico University-Main Campus,5847,4107,3002,2845
187666,Eastern New Mexico University-Roswell Campus,3883,2071,1155,2728
383996,Eastern New Mexico University-Ruidoso Campus,895,457,235,660
418348,Eastern Oklahoma County Technology Center,500,222,81,419
207050,Eastern Oklahoma State College,1832,1276,995,837
208646,Eastern Oregon University,4157,2974,2198,1959
446224,Eastern School of Acupuncture and Traditional Medicine,64,63,63,1
232052,Eastern Shore Community College,857,463,264,593
418065,Eastern Suffolk BOCES-Practical Nursing Program,339,281,252,87
212133,Eastern University,4004,3270,2808,1196
231970,Eastern Virginia Medical School,1017,983,963,54
235097,Eastern Washington University,12791,11439,10544,2247
438708,Eastern West Virginia Community and Technical College,867,486,293,574
240596,Eastern Wyoming College,1788,1056,686,1102
224572,Eastfield College,14529,7095,3338,11191
407461,Eastland-Fairfield Career and Technical Schools,188,188,188,0
183488,Eastwick College-Hackensack,324,248,198,126
184959,Eastwick College-Ramsey,1034,697,475,559
446233,Ecclesia College,178,157,144,34
133492,Eckerd College,2173,2036,1947,226
446534,eClips School of Cosmetology and Barbering,114,114,114,0
460215,Ecotech Institute,476,439,414,62
248934,ECPI University,10845,10504,10283,562
247162,Ecumenical Theological Seminary,81,55,39,42
177278,Eden Theological Seminary,167,126,100,67
198491,Edgecombe Community College,2808,1875,1404,1404
238661,Edgewood College,2894,2219,1796,1098
376321,EDIC College,752,610,517,235
212160,Edinboro University of Pennsylvania,7098,6273,5770,1328
133508,Edison State College,15423,9230,5040,10383
202648,Edison State Community College,2993,1587,877,2116
235103,Edmonds Community College,9070,5824,4184,4886
457794,EDP School of Computer Programming,82,78,75,7
243832,EDP Univeristy of Puerto Rico Inc-San Juan,1348,1041,843,505
241836,EDP University of Puerto Rico Inc-San Sebastian,1195,986,850,345
455938,Education and Technology Institute,15,15,15,0
240985,Educational Technical College-Recinto de Bayamon,225,225,225,0
448707,Educational Technical College-Recinto de Coamo,254,254,254,0
448716,Educational Technical College-Recinto de san Sebastian,276,276,276,0
146454,Educators of Beauty College of Cosmetology-La Salle,33,33,33,0
260965,Educators of Beauty College of Cosmetology-Rockford,61,61,61,0
149204,Educators of Beauty College of Cosmetology-Sterling,45,45,45,0
442806,Edward Via College of Osteopathic Medicine,1278,1278,1278,0
133526,Edward Waters College,862,852,845,17
202657,EHOVE Career Center,302,262,242,60
410964,EINE Inc,35,25,19,16
112686,El Camino College-Compton Center,7693,3842,1896,5797
113980,El Camino Community College District,23996,13281,7866,16130
224615,El Centro College,10771,4939,1992,8779
224642,El Paso Community College,30468,16734,9792,20676
476887,Elaine Sterling Institute,133,90,62,71
177287,Elaine Steven Beauty College,186,164,149,37
179724,Eldon Career Center,21,21,21,0
114044,Elegance International,205,205,205,0
144944,Elgin Community College,11285,6300,3780,7505
441317,Eli Whitney Technical High School,41,41,41,0
448053,Elite Academy of Beauty Arts,52,52,52,0
451529,Elite College of Cosmetology,51,30,16,35
461607,Elite Cosmetology School,90,85,82,8
461999,Elite School of Cosmetology,34,34,34,0
198507,Elizabeth City State University,2421,2259,2155,266
362782,Elizabeth Grady School of Esthetics and Massage Therapy,171,146,129,42
212197,Elizabethtown College,1892,1870,1856,36
480134,Elizabethtown College School of Continuing and Professional Studies,440,172,0,440
156648,Elizabethtown Community and Technical College,6929,4358,3058,3871
153296,Ellsworth Community College,1034,829,725,309
144962,Elmhurst College,3210,2947,2782,428
190974,Elmira Business Institute,431,380,346,85
190983,Elmira College,1542,1333,1200,342
198516,Elon University,6305,6150,6052,253
133553,Embry-Riddle Aeronautical University-Daytona Beach,5279,5006,4831,448
104586,Embry-Riddle Aeronautical University-Prescott,1921,1839,1786,135
426314,Embry-Riddle Aeronautical University-Worldwide,14564,8948,5356,9208
165662,Emerson College,4561,4447,4375,186
387660,Emil Fries Piano Hospital and Training Center,3,3,3,0
127158,Emily Griffith Technical College,2802,1274,502,2300
404684,Emma's Beauty Academy-Juana Diaz,404,404,404,0
241906,Emma's Beauty Academy-Mayaguez,397,397,397,0
220136,Emmanuel Christian Seminary,124,79,51,73
165671,Emmanuel College,2436,2092,1874,562
139630,Emmanuel College,806,743,702,104
153302,Emmaus Bible College,187,182,179,8
232025,Emory & Henry College,959,919,894,65
139658,Emory University,14513,13692,13181,1332
114114,Emperor's College of Traditional Oriental Medicine,203,145,109,94
212328,Empire Beauty  School-Lehigh Valley,142,118,103,39
407726,Empire Beauty School-Appleton,67,56,49,18
450623,Empire Beauty School-Arlington Heights,168,115,80,88
381750,Empire Beauty School-Arvada,52,45,41,11
481678,Empire Beauty School-Augusta,79,79,79,0
447175,Empire Beauty School-Aurora,136,116,103,33
447148,Empire Beauty School-Avondale,249,210,184,65
368230,Empire Beauty School-Bloomfield,180,152,134,46
174978,Empire Beauty School-Bloomington,148,129,116,32
430218,Empire Beauty School-Bordentown,114,95,82,32
164845,Empire Beauty School-Boston,241,198,170,71
383765,Empire Beauty School-Brooklyn,63,63,63,0
375984,Empire Beauty School-Center City Philadelphia,337,303,281,56
104443,Empire Beauty School-Chandler,113,97,86,27
157614,Empire Beauty School-Chenoweth,107,91,80,27
184816,Empire Beauty School-Cherry Hill,91,78,69,22
407470,Empire Beauty School-Cincinnati,186,148,123,63
450614,Empire Beauty School-Concord,123,108,98,25
157669,Empire Beauty School-Dixie,123,113,107,16
417381,Empire Beauty School-Dunwoody,168,150,138,30
458803,Empire Beauty School-E Memphis,169,145,129,40
453570,Empire Beauty School-Eden Prairie,50,50,50,0
157650,Empire Beauty School-Elizabethtown,168,147,134,34
212683,Empire Beauty School-Exton,90,79,72,18
104434,Empire Beauty School-Flagstaff,53,53,53,0
157678,Empire Beauty School-Florence,165,143,128,37
443678,Empire Beauty School-Framingham,94,71,56,38
480310,Empire Beauty School-Glen Burnie,194,173,159,35
407735,Empire Beauty School-Green Bay,102,102,102,0
212337,Empire Beauty School-Gwinnett,169,147,133,36
415039,Empire Beauty School-Hanover,96,82,73,23
143543,Empire Beauty School-Hanover Park,81,60,47,34
212382,Empire Beauty School-Harrisburg,164,139,123,41
262660,Empire Beauty School-Highland,80,63,52,28
450641,Empire Beauty School-Hooksett,119,103,93,26
248305,Empire Beauty School-Hurstborne,118,105,97,21
381635,Empire Beauty School-Hyannis,77,60,49,28
151652,Empire Beauty School-Indianapolis,194,170,155,39
458821,Empire Beauty School-Jackson,94,94,94,0
185730,Empire Beauty School-Jersey City,71,71,71,0
440101,Empire Beauty School-Kennesaw,188,155,134,54
182704,Empire Beauty School-Laconia,103,86,74,29
126854,Empire Beauty School-Lakewood,62,62,62,0
212276,Empire Beauty School-Lancaster,112,95,83,29
456126,Empire Beauty School-Lauderhill,101,87,78,23
212708,Empire Beauty School-Laurel Springs,141,120,106,35
212230,Empire Beauty School-Lebanon,31,31,31,0
450580,Empire Beauty School-Lisle,88,73,63,25
447166,Empire Beauty School-Littleton,92,80,72,20
367130,Empire Beauty School-Lowell,116,93,78,38
239132,Empire Beauty School-Madison,89,78,70,19
161493,Empire Beauty School-Maine,314,285,266,48
407179,Empire Beauty School-Malden,155,137,125,30
195067,Empire Beauty School-Manhattan,665,541,459,206
246594,Empire Beauty School-Manitowoc,72,72,72,0
199713,Empire Beauty School-Matthews,97,96,96,1
169284,Empire Beauty School-Michigan,365,323,295,70
444282,Empire Beauty School-Midlothian,145,126,114,31
448798,Empire Beauty School-Milwaukee,66,63,61,5
430227,Empire Beauty School-Monroeville,130,109,96,34
458867,Empire Beauty School-Morrow,255,218,194,61
458812,Empire Beauty School-Nashville,65,65,65,0
212753,Empire Beauty School-NE Philadelphia,211,181,161,50
450605,Empire Beauty School-North Hills,127,107,94,33
447157,Empire Beauty School-North Tucson,6,5,4,2
106111,Empire Beauty School-NW Phoenix,172,147,130,42
184144,Empire Beauty School-Ocean,129,114,104,25
444291,Empire Beauty School-Owings Mills,122,106,95,27
103732,Empire Beauty School-Paradise Valley,43,38,34,9
458849,Empire Beauty School-Paramus,130,111,99,31
193991,Empire Beauty School-Peekskill,43,43,43,0
459064,Empire Beauty School-Pineville,105,93,85,20
450757,Empire Beauty School-Portsmouth,104,91,83,21
212300,Empire Beauty School-Pottsville,57,57,57,0
262299,Empire Beauty School-Prescott,84,74,68,16
217095,Empire Beauty School-Providence,135,114,100,35
190239,Empire Beauty School-Queens,215,179,156,59
212391,Empire Beauty School-Reading,104,82,67,37
450599,Empire Beauty School-Richmond,140,138,137,3
481845,Empire Beauty School-Rochester,133,117,107,26
478582,Empire Beauty School-Savannah,164,137,120,44
212294,Empire Beauty School-Shamokin Dam,50,50,50,0
182722,Empire Beauty School-Somersworth,140,127,119,21
458858,Empire Beauty School-Speedway,170,146,130,40
456135,Empire Beauty School-Spring Lake Park,110,91,78,32
458830,Empire Beauty School-Springfield,197,155,127,70
445504,Empire Beauty School-St Paul,76,62,53,23
212212,Empire Beauty School-State College,39,39,39,0
481748,Empire Beauty School-Stone Park,196,180,169,27
128337,Empire Beauty School-Thornton,161,137,121,40
103741,Empire Beauty School-Tucson,175,154,140,35
184506,Empire Beauty School-Union,126,106,93,33
481739,Empire Beauty School-Vernon Hills,68,68,68,0
476179,Empire Beauty School-Virginia Beach,181,154,136,45
212373,Empire Beauty School-Warminster,74,61,53,21
217581,Empire Beauty School-Warwick,88,72,62,26
478616,Empire Beauty School-West Greensboro,111,102,96,15
444307,Empire Beauty School-West Mifflin,109,91,79,30
459055,Empire Beauty School-West Palm,111,92,79,32
212285,Empire Beauty School-Williamsport,46,44,43,3
212355,Empire Beauty School-Wyoming Valley,182,157,140,42
212267,Empire Beauty School-York,135,110,94,41
114123,Empire College School of Business,419,413,409,10
446242,Employment Solutions-College for Technical Education,176,176,176,0
155025,Emporia State University,6033,4617,3787,2246
480718,EMS Training Institute,103,41,0,103
165699,Endicott College,5029,3667,2819,2210
207087,Enid Beauty College,43,43,43,0
101143,Enterprise State Community College,2333,1659,1318,1015
461801,Entourage Institute of Beauty and Esthetics,51,51,51,0
124487,Epic Bible College,265,159,90,175
165705,Episcopal Divinity School,70,49,36,34
224712,Episcopal Theological Seminary of the Southwest,102,66,43,59
457581,Eric Fisher Academy,152,152,152,0
439622,Erie 1 BOCES,155,155,155,0
383525,Erie 2 Chautauqua Cattaraugus BOCES-Practical Nursing Program,85,85,85,0
212425,Erie Business Center-Erie,209,157,122,87
213686,Erie Business Center-New Castle,79,67,59,20
191083,Erie Community College,13649,10587,9039,4610
212434,Erie Institute of Technology Inc,216,216,216,0
409254,Erikson Institute,253,123,42,211
217998,Erskine College,815,772,744,71
241951,Escuela de Artes Plasticas de Puerto Rico,529,434,370,159
420255,Escuela de Peritos Electricistas de Isabela Inc,61,61,61,0
452106,Escuela De Troqueleria Y Herramentaje,100,100,100,0
444583,Escuela Hotelera de San Juan,886,886,886,0
431123,Escuela Tecnica de Electricidad,356,356,356,0
184481,Essex County College,12175,8333,6391,5784
461582,Estelle Skin Care and Spa Institute,95,58,34,61
417062,Estes Institute of Cosmetology Arts and Science,89,89,89,0
384333,Estrella Mountain Community College,8832,4832,2810,6022
476522,Eternity Cosmetology School,205,109,45,160
244613,ETI School of Skilled Trades,309,216,155,154
200590,ETI Technical College,161,127,105,56
450739,Euphoria Institute of Beauty Arts & Sciences-Green Valley,172,123,90,82
456250,Euphoria Institute of Beauty Arts & Sciences-Las Vegas,149,122,104,45
450720,Euphoria Institute of Beauty Arts & Sciences-Summerlin,142,110,89,53
144971,Eureka College,692,663,644,48
459338,Eureka Institute of Health and Beauty,75,75,75,0
457332,European Academy of Cosmetology and Hairdressing,38,23,13,25
458423,European Massage Therapy School-Las Vegas,96,38,0,96
446251,European Massage Therapy School-Skokie,67,67,67,0
177339,Evangel University,2274,2097,1984,290
212443,Evangelical Theological Seminary,113,62,31,82
230199,Evans Hairstyling College-Cedar City,33,33,33,0
454935,Evans Hairstyling College-Rexburg,67,67,67,0
230205,Evans Hairstyling College-St George,50,47,45,5
119465,Everest College-Alhambra,561,561,561,0
371982,Everest College-Anaheim,574,535,510,64
443854,Everest College-Arlington,643,618,602,41
467784,Everest College-Atlanta West,634,634,634,0
366544,Everest College-Aurora,383,349,326,57
467155,Everest College-Bedford Park,705,705,705,0
234739,Everest College-Bremerton,273,271,269,4
442736,Everest College-Burr Ridge,288,288,288,0
438647,Everest College-Chesapeake,840,803,779,61
372037,Everest College-City of Industry,1029,983,953,76
126401,Everest College-Colorado Springs,389,341,310,79
442790,Everest College-Dallas,1071,961,889,182
447227,Everest College-Earth City,573,573,573,0
363590,Everest College-Everett,451,444,440,11
445197,Everest College-Fort Worth,505,478,460,45
460358,Everest College-Fort Worth South,535,496,471,64
119456,Everest College-Gardena,494,494,494,0
109332,Everest College-Hayward,170,170,170,0
182148,Everest College-Henderson,915,794,714,201
480338,Everest College-Kansas City,406,406,406,0
119368,Everest College-LA Wilshire,232,227,223,9
445470,Everest College-McLean,237,220,208,29
467881,Everest College-Melrose Park,545,545,545,0
430175,Everest College-Merrillville,645,645,645,0
447218,Everest College-Merrionette Park,420,420,420,0
447236,Everest College-Mesa,367,311,274,93
232502,Everest College-Newport News,525,476,444,81
445771,Everest College-North Aurora,275,275,275,0
371265,Everest College-Ontario,782,782,782,0
440299,Everest College-Ontario Metro,962,768,643,319
103644,Everest College-Phoenix,2761,1988,1488,1273
210359,Everest College-Portland,227,164,122,105
234784,Everest College-Renton,444,444,444,0
119359,Everest College-Reseda,696,683,675,21
230472,Everest College-Salt Lake City,404,352,319,85
119508,Everest College-San Bernardino,747,711,688,59
119340,Everest College-San Francisco,267,267,267,0
119438,Everest College-San Jose,172,172,172,0
460367,Everest College-Santa Ana,433,433,433,0
236531,Everest College-Seattle,174,174,174,0
171313,Everest College-Skokie,459,459,459,0
179070,Everest College-Springfield,303,250,215,88
444024,Everest College-Tacoma,859,849,842,17
127787,Everest College-Thornton,371,321,288,83
430980,Everest College-Torrance,167,167,167,0
236993,Everest College-Vancouver,324,294,274,50
368805,Everest College-West Los Angeles,422,395,378,44
480329,Everest College-Woodbridge,570,570,570,0
442727,Everest Institute-Austin,880,880,880,0
476328,Everest Institute-Bensalem,514,514,514,0
445461,Everest Institute-Bissonnet,934,934,934,0
167020,Everest Institute-Brighton,369,369,369,0
445373,Everest Institute-Chelsea,434,434,434,0
237604,Everest Institute-Cross Lanes,232,232,232,0
440369,Everest Institute-Dearborn,666,666,666,0
444237,Everest Institute-Detroit,494,494,494,0
445382,Everest Institute-Eagan,327,327,327,0
447209,Everest Institute-Gahanna,462,462,462,0
170046,Everest Institute-Grand Rapids,576,576,576,0
438656,Everest Institute-Greenspoint,501,501,501,0
441016,Everest Institute-Hobby,557,557,557,0
438197,Everest Institute-Jonesboro,406,406,406,0
373890,Everest Institute-Kalamazoo,356,356,356,0
409670,Everest Institute-Kendall,461,415,385,76
430421,Everest Institute-Marietta,329,329,329,0
443748,Everest Institute-Norcross,527,525,523,4
135957,Everest Institute-North Miami,768,708,669,99
212090,Everest Institute-Pittsburgh,600,516,460,140
194967,Everest Institute-Rochester,617,491,408,209
227003,Everest Institute-San Antonio,493,493,493,0
447245,Everest Institute-Silver Spring,527,527,527,0
449269,Everest Institute-South Plainfield,697,697,697,0
171322,Everest Institute-Southfield,1003,1003,1003,0
442620,Everest Institute-Tigard,314,314,314,0
260293,Everest University-Brandon,4318,3045,2224,2094
438902,Everest University-Jacksonville,665,565,501,164
367909,Everest University-Lakeland,449,370,319,130
137810,Everest University-Largo,486,414,368,118
420006,Everest University-Melbourne,522,434,378,144
136288,Everest University-North Orlando,759,640,563,196
445434,Everest University-Orange Park,711,628,575,136
134149,Everest University-Pompano Beach,2054,1512,1166,888
390701,Everest University-South Orlando,29693,21036,15437,14256
137801,Everest University-Tampa,770,685,630,140
235149,Everett Community College,7154,5009,3925,3229
385619,Everglades University,1252,1222,1203,49
234650,Evergreen Beauty and Barber College-Bellevue,100,100,100,0
446260,Evergreen Beauty and Barber College-Everett,128,128,128,0
114266,Evergreen Valley College,9211,4945,2789,6422
207102,Eves College of Hairstyling,86,86,86,0
476577,Excel Learning Center,80,80,80,0
196680,Excelsior College,39897,15647,0,39897
444592,Expertise Cosmetology Institute,29,21,16,13
224758,Exposito School of Hair Design,58,48,42,16
447458,Expression College for Digital Arts,574,574,574,0
129242,Fairfield University,4919,4311,3930,989
184694,Fairleigh Dickinson University-College at Florham,3029,2754,2582,447
184603,Fairleigh Dickinson University-Metropolitan Campus,8546,5524,3596,4950
237367,Fairmont State University,4232,3813,3541,691
387819,Fairview Beauty Academy,105,97,91,14
153320,Faith Baptist Bible College and Theological Seminary,267,239,222,45
443049,Faith Evangelical College & Seminary,318,257,219,99
212452,Faith Theological Seminary,380,350,331,49
443058,Family of Faith College,39,26,18,21
415729,Faris Technical Institute Inc,19,14,11,8
196042,Farmingdale State College,8162,6917,6074,2088
138132,Fashion Focus Hair Academy,79,67,59,20
114354,Fashion Institute of Design & Merchandising-Los Angeles,3459,3224,3072,387
114415,Fashion Institute of Design & Merchandising-Orange County,214,209,205,9
248846,Fashion Institute of Design & Merchandising-San Diego,169,158,151,18
114390,Fashion Institute of Design & Merchandising-San Francisco,637,602,580,57
191126,Fashion Institute of Technology,9755,8334,7377,2378
101189,Faulkner University,3193,2663,2321,872
381486,Faust Institute of Cosmetology-Spirit Lake,14,14,14,0
153339,Faust Institute of Cosmetology-Storm Lake,21,21,21,0
439631,Fayette Beauty Academy,34,34,34,0
248624,Fayette County Career & Technical Institute Practical Nursing Program,109,109,109,0
413176,Fayette Institute of Technology,43,43,43,0
198525,Fayetteville Beauty College,47,46,46,1
220163,Fayetteville College of Cosmetology Arts and Sciences,71,37,14,57
198543,Fayetteville State University,6179,5056,4325,1854
198534,Fayetteville Technical Community College,12398,7563,5119,7279
114433,Feather River Community College District,1782,1021,636,1146
114460,Federico Beauty Institute,246,200,169,77
184612,Felician College,1933,1591,1374,559
169910,Ferris State University,14707,11921,10066,4641
232089,Ferrum College,1512,1500,1492,20
114549,Fielding Graduate University,1190,1050,963,227
436599,FINE Mortuary College,76,36,10,66
191199,Finger Lakes Community College,6389,4406,3404,2985
475422,Finger Lakes Health College of Nursing,119,60,21,98
457864,Finger Lakes School of Massage,113,79,56,57
482103,Finger Lakes School of Massage,57,23,0,57
460552,Finger Lakes School of Massage,56,49,44,12
172440,Finlandia University,525,488,464,61
205090,Firelands Regional Medical Center School of Nursing,99,80,67,32
461874,First Class Cosmetology School,66,66,66,0
137023,First Coast Technical College,631,482,406,225
145099,First Institute Inc,53,53,53,0
165802,Fisher College,1930,1504,1229,701
220181,Fisk University,646,625,612,34
165820,Fitchburg State University,6680,4768,3632,3048
114585,Five Branches University,402,344,308,94
191205,Five Towns College,796,761,739,57
133711,Flagler College-St Augustine,2839,2783,2746,93
444990,Flagler College-Tallahassee,478,454,439,39
461245,Flagler Technical Institute,338,164,76,262
476513,Flair Beauty College,60,60,60,0
180197,Flathead Valley Community College,2216,1463,1082,1134
155052,Flint Hills Technical College,834,618,509,325
169947,Flint Institute of Barbering Inc,56,56,56,0
218025,Florence-Darlington Technical College,5991,3903,2848,3143
462035,Florida Academy,65,57,52,13
447908,Florida Academy of Health & Beauty,29,27,25,4
133650,Florida Agricultural and Mechanical University,10743,10049,9597,1146
133669,Florida Atlantic University,30759,22888,17779,12980
441380,Florida Barber Academy,201,174,157,44
133997,Florida Career College-Miami,5818,5818,5818,0
434715,Florida Coastal School of Law,1279,1174,1109,170
133809,Florida College,558,543,533,25
434441,Florida College of Integrative Medicine,147,147,147,0
438294,Florida College of Natural Health-Bradenton,127,127,127,0
438285,Florida College of Natural Health-Maitland,380,380,380,0
420103,Florida College of Natural Health-Miami,201,201,201,0
387925,Florida College of Natural Health-Pompano Beach,262,262,262,0
441423,Florida Education Institute,350,350,350,0
135160,Florida Gateway College,3057,1801,951,2106
433660,Florida Gulf Coast University,14077,11934,10539,3538
476814,Florida Institute of Recording Sound and Technology,152,60,0,152
133881,Florida Institute of Technology,5644,4715,4138,1506
480569,Florida Institute of Technology-Online,3466,2178,1365,2101
133942,Florida Institute of Ultrasound Inc,68,68,68,0
133951,Florida International University,47663,38174,31932,15731
133960,Florida Keys Community College,1139,671,435,704
133979,Florida Memorial University,1560,1481,1430,130
408844,Florida National University-Main Campus,2448,2038,1773,675
134024,Florida School of Massage,70,69,69,1
457350,Florida School of Traditional Midwifery,34,13,0,34
134079,Florida Southern College,2619,2415,2283,336
133702,Florida State College at Jacksonville,28134,16851,9217,18917
134097,Florida State University,40909,37213,34882,6027
134112,Florida Technical College,4330,4330,4330,0
476939,Florida Vocational Institute,87,35,0,87
455035,Focus-Hope Information Technologies Center,17,17,17,0
444219,Folsom Lake College,8034,4037,2017,6017
380368,Fond du Lac Tribal and Community College,2272,1310,824,1448
177418,Fontbonne University,1997,1504,1192,805
114716,Foothill College,14814,8472,5266,9548
419332,Forbes Road Career and Technology Center,28,21,17,11
191241,Fordham University,15097,13200,12015,3082
177427,Forest Institute of Professional Psychology,254,220,199,55
218043,Forrest College,135,112,97,38
198552,Forsyth Technical Community College,9528,6130,4412,5116
200086,Fort Berthold Community College,203,158,128,75
155061,Fort Hays State University,13441,8941,5999,7442
127185,Fort Lewis College,4021,3810,3670,351
135267,Fort Myers Institute of Technology,816,742,705,111
180212,Fort Peck Community College,405,287,228,177
134228,Fort Pierce Beauty Academy,28,26,24,4
155098,Fort Scott Community College,1931,1287,962,969
139719,Fort Valley State University,3180,2882,2695,485
224828,Fort Worth Beauty School,60,40,27,33
455497,Fortis College School of Cosmetology,80,80,80,0
467340,Fortis College-Akron,144,144,144,0
439738,Fortis College-Baton Rouge,381,381,381,0
205179,Fortis College-Centerville,2802,2802,2802,0
450067,Fortis College-Cincinnati,501,501,501,0
460020,Fortis College-Columbia,543,543,543,0
450058,Fortis College-Columbus,628,628,628,0
480143,Fortis College-Cutler Bay,203,203,203,0
204307,Fortis College-Cuyahoga Falls,471,425,394,77
455460,Fortis College-Dothan,208,208,208,0
436641,Fortis College-Foley,175,159,148,27
392415,Fortis College-Houston,382,382,382,0
458681,Fortis College-Indianapolis,172,172,172,0
451909,Fortis College-Landover,487,487,487,0
447360,Fortis College-Largo,279,279,279,0
404921,Fortis College-Miami,88,88,88,0
371052,Fortis College-Mobile,359,359,359,0
455488,Fortis College-Montgomery,363,319,290,73
475130,Fortis College-Montgomery,192,192,192,0
233329,Fortis College-Norfolk,291,291,291,0
439792,Fortis College-Orange Park,266,266,266,0
456180,Fortis College-Phoenix,271,271,271,0
201399,Fortis College-Ravenna,356,302,267,89
382957,Fortis College-Richmond,457,457,457,0
456454,Fortis College-Salt Lake City,333,333,333,0
372921,Fortis College-Smyrna,617,617,617,0
136075,Fortis College-Tampa,39,39,39,0
132806,Fortis College-Winter Park,59,59,59,0
450076,Fortis Institute-Baltimore,543,543,543,0
455628,Fortis Institute-Birmingham,711,711,711,0
418870,Fortis Institute-Cookeville,247,247,247,0
216418,Fortis Institute-Erie,851,618,465,386
443438,Fortis Institute-Fort Lauderdale,214,214,214,0
249609,Fortis Institute-Forty Fort,224,224,224,0
458478,Fortis Institute-Grand Prairie,304,304,304,0
459958,Fortis Institute-Houston,333,333,333,0
444079,Fortis Institute-Jacksonville,158,150,144,14
475024,Fortis Institute-Lawrenceville,270,270,270,0
445753,Fortis Institute-Miami,130,130,130,0
250498,Fortis Institute-Mulberry,109,109,109,0
452124,Fortis Institute-Nashville,346,346,346,0
455479,Fortis Institute-Pensacola,817,817,817,0
445744,Fortis Institute-Port Saint Lucie,464,464,464,0
385503,Fortis Institute-Scranton,464,430,408,56
163347,Fortis Institute-Towson,748,748,748,0
183725,Fortis Institute-Wayne,567,567,567,0
175698,Fosters Cosmetology College,32,19,11,21
221795,Fountainhead College of Technology,180,180,180,0
457873,Four County Career Center,142,77,44,98
177436,Four Rivers Career Center,41,36,34,7
415774,Four-D College,641,518,437,204
145239,Fox College,387,387,387,0
184092,Fox Institute of Business-Clifton,611,611,611,0
129482,Fox Institute of Business-West Hartford,327,327,327,0
238722,Fox Valley Technical College,10511,5463,2911,7600
165866,Framingham State University,6429,4896,3982,2447
218061,Francis Marion University,4058,3647,3388,670
245999,Francis Tuttle Technology Center,2014,1057,573,1441
114734,Franciscan School of Theology,44,29,20,24
205957,Franciscan University of Steubenville,2733,2373,2148,585
420200,Francois D College of Hair Skin and Nails,92,50,23,69
104665,Frank Lloyd Wright School of Architecture,10,10,10,0
224891,Frank Phillips College,1148,718,501,647
404718,Franklin Academy,105,105,105,0
212577,Franklin and Marshall College,2297,2273,2258,39
224907,Franklin Beauty School,106,87,75,31
436012,Franklin Career Institute,711,711,711,0
150604,Franklin College,1014,976,952,62
248633,Franklin County Career and Technology Center,60,60,60,0
182795,Franklin Pierce University,2204,1962,1809,395
409120,Franklin Technology-MSSU,189,189,189,0
202806,Franklin University,6274,4022,2570,3704
441982,Franklin W Olin College of Engineering,355,355,355,0
237844,Fred W Eberle Technical Center,120,101,91,29
162557,Frederick Community College,6050,3537,2267,3783
455017,Frederick School of Cosmetology,35,27,22,13
114761,Fredrick and Charles Beauty College,83,81,80,3
220215,Freed-Hardeman University,1811,1535,1363,448
372073,Fremont College,344,344,344,0
455062,French Academy of Cosmetology,73,45,27,46
114789,Fresno City College,21344,12357,7815,13529
114813,Fresno Pacific University,3393,2798,2423,970
155089,Friends University,2178,1583,1206,972
127200,Front Range Community College,19619,10652,6120,13499
403469,Frontier Community College,2194,887,226,1968
156727,Frontier Nursing University,1427,1025,777,650
162584,Frostburg State University,5473,4815,4408,1065
134237,Full Sail University,20949,20949,20949,0
181136,Fullen School of Hair Design,34,34,34,0
114840,Fuller Theological Seminary in California,2694,1477,724,1970
114859,Fullerton College,24301,13765,8440,15861
191302,Fulton-Montgomery Community College,2781,2079,1724,1057
218070,Furman University,2953,2812,2722,231
476498,Futura Career Institute,100,100,100,0
481030,Future Generations Graduate School,29,29,29,0
459310,Future-Tech Institute,35,35,35,0
407090,G Skin & Beauty Institute,286,176,103,183
101240,Gadsden State Community College,5797,4062,3185,2612
461254,Galaxy Medical College,31,31,31,0
452948,Galen College of Nursing-Cincinnati,505,368,278,227
156471,Galen College of Nursing-Louisville,847,632,490,357
406033,Galen College of Nursing-San Antonio,1119,875,715,404
406024,Galen College of Nursing-Tampa Bay,790,571,427,363
131450,Gallaudet University,1561,1442,1367,194
451282,Gallery College of Beauty,193,152,125,68
205513,Gallipolis Career College,105,77,58,47
224961,Galveston College,2131,1099,577,1554
212601,Gannon University,4211,3537,3111,1100
155104,Garden City Community College,1997,1381,1069,928
198561,Gardner-Webb University,4656,3505,2784,1872
431169,Garnet Career Center,117,117,117,0
162609,Garrett College,769,655,597,172
145275,Garrett-Evangelical Theological Seminary,399,294,229,170
458131,Gary Manuel Aveda Institute,287,287,287,0
198570,Gaston College,5977,3399,2096,3881
157438,Gateway Community and Technical College,4646,2534,1467,3179
130396,Gateway Community College,8186,4535,2689,5497
105145,GateWay Community College,6440,3056,1345,5095
238759,Gateway Technical College,8268,3827,1582,6686
114938,Gavilan College,5834,3191,1855,3979
460385,Geisinger-Lewistown Hospital School of Nursing,55,48,44,11
145309,Gem City College,44,44,44,0
480912,Gemini School of Visual Arts & Communication,10,10,10,0
114947,Gemological Institute of America-Carlsbad,192,192,192,0
191311,Gemological Institute of America-New York,193,193,193,0
407708,Gene Juarez Academy of Beauty-Federal Way,360,360,360,0
235583,Gene Juarez Academy of Beauty-Mountlake Terrace,230,230,230,0
191339,Genesee Community College,7079,4586,3326,3753
431196,Genesee Valley BOCES-Practical Nursing Program,143,143,143,0
220765,Genesis Career College-Cookeville,518,486,465,53
382780,Genesis Career College-Lebanon,247,247,247,0
212656,Geneva College,1852,1740,1669,183
451361,Gentle Healing School of Massage,22,19,17,5
101286,George C Wallace State Community College-Dothan,4686,3097,2294,2392
101295,George C Wallace State Community College-Hanceville,5281,3735,2954,2327
101301,George C Wallace State Community College-Selma,1745,1295,1068,677
208822,George Fox University,3712,2962,2493,1219
232186,George Mason University,33917,26139,21421,12496
134291,George Stone Technical Center,675,596,556,119
134307,George T Baker Aviation School,710,452,321,389
131469,George Washington University,25264,20233,17109,8155
156745,Georgetown College,1399,1163,1017,382
131496,Georgetown University,17849,15726,14407,3442
456092,Georgia Beauty Academy,131,100,80,51
138822,Georgia Career Institute,528,528,528,0
461236,Georgia Christian University,251,249,248,3
139861,Georgia College and State University,6551,5963,5600,951
447689,Georgia Gwinnett College,9719,7997,6832,2887
139700,Georgia Highlands College,5492,3732,2843,2649
408862,Georgia Institute of Cosmetology,302,186,109,193
139755,Georgia Institute of Technology-Main Campus,21471,19783,18743,2728
139904,Georgia Military College,1651,1442,1336,315
482857,Georgia Military College-Distance Learning Campuses,5418,3448,2452,2966
139384,Georgia Northwestern Technical College,6051,3450,2135,3916
244437,Georgia Perimeter College,21123,12499,8140,12983
244446,Georgia Piedmont Technical College,4431,2464,1470,2961
482149,Georgia Regents University,8468,7349,6628,1840
139931,Georgia Southern University,20517,18213,16767,3750
139764,Georgia Southwestern State University,2806,2290,1946,860
139940,Georgia State University,32165,27017,23677,8488
184773,Georgian Court University,2257,1775,1471,786
202888,Gerbers Akron Beauty School,67,47,34,33
232195,Germanna Community College,7379,4040,2352,5027
212674,Gettysburg College,2524,2520,2517,7
238786,Gill-Tech Academy of Hair Design,113,101,93,20
235307,Glen Dow Academy of Hair Design,153,152,151,2
169974,Glen Oaks Community College,1221,763,531,690
115010,Glendale Career College,293,293,293,0
115001,Glendale Community College,15744,10045,7164,8580
104708,Glendale Community College,20872,11806,7224,13648
237385,Glenville State College,1850,1411,1114,736
127219,Glenwood Beauty Academy,53,49,46,7
455390,Global Health College,265,161,93,172
475644,Global Institute,24,24,24,0
188465,Globe Institute of Technology,557,542,532,25
466514,Globe University-Appleton,269,220,189,80
456816,Globe University-Eau Claire,221,185,161,60
458991,Globe University-La Crosse,245,214,194,51
458733,Globe University-Madison East,266,224,197,69
456834,Globe University-Minneapolis,237,188,158,79
456807,Globe University-Sioux Falls,171,152,139,32
173629,Globe University-Woodbury,983,771,635,348
458751,Globe University–Green Bay,243,199,171,72
458760,Globe University–Madison West,216,183,162,54
458779,Globe University–Wausau,194,159,137,57
421586,Globelle Technical Institute,96,96,96,0
184791,Gloucester County College,6720,4933,4030,2690
449384,Gnomon School of Visual Effects,135,135,135,0
230889,Goddard College,592,586,582,10
202903,Gods Bible School and College,305,244,204,101
169992,Gogebic Community College,1099,799,647,452
115083,Golden Gate University-San Francisco,3227,1935,1130,2097
459143,Golden State College of Court Reporting,68,58,51,17
115126,Golden West College,12717,7281,4534,8183
130989,Goldey-Beacom College,1868,980,429,1439
430157,Golf Academy of America-Altamonte Springs,255,245,238,17
122366,Golf Academy of America-Carlsbad,230,221,215,15
476337,Golf Academy of America-Farmers Branch,134,129,126,8
434690,Golf Academy of America-Myrtle Beach,299,289,283,16
430166,Golf Academy of America-Phoenix,171,164,159,12
235316,Gonzaga University,7605,6299,5490,2115
202912,Good Samaritan College of Nursing and Health Science,355,229,148,207
132523,Gooding Institute of Nurse Anesthesia,35,35,35,0
129154,Goodwin College,3388,1691,593,2795
165936,Gordon College,2073,1885,1768,305
375683,Gordon Cooper Technology Center,923,445,204,719
139968,Gordon State College,4187,3335,2758,1429
165945,Gordon-Conwell Theological Seminary,2137,1270,734,1403
150668,Goshen College,888,810,760,128
162654,Goucher College,2111,1786,1585,526
145336,Governors State University,5568,3376,2009,3559
363679,Grabber School of Hair Design,134,112,98,36
170000,Grace Bible College,579,493,438,141
150677,Grace College and Theological Seminary,1904,1606,1416,488
481377,Grace College of Barbering,25,25,25,0
461528,Grace College of Divinity,110,66,38,72
481058,Grace Mission University,136,115,101,35
481401,Grace School of Theology,114,56,20,94
181093,Grace University,481,414,372,109
153366,Graceland University-Lamoni,2286,1896,1650,636
115214,Graduate Theological Union,253,240,232,21
139746,Grady Health System Professional Schools,60,60,60,0
145354,Graham Hospital School of Nursing,82,48,25,57
406495,Graham Webb International Academy of Hair,160,139,125,35
159009,Grambling State University,5071,4607,4325,746
104717,Grand Canyon University,55497,26455,8023,47474
170055,Grand Rapids Community College,16590,9336,5669,10921
176983,Grand River Technical School,90,90,90,0
170082,Grand Valley State University,24477,21632,19853,4624
153375,Grand View University,2129,1885,1728,401
183257,Granite State College,2058,1427,1017,1041
442569,Grantham University,11188,9153,7841,3347
212771,Gratz College,673,289,51,622
235334,Grays Harbor College,1958,1551,1345,613
225070,Grayson College,5014,3079,2101,2913
182306,Great Basin College,3181,1824,907,2274
183150,Great Bay Community College,2122,1120,614,1508
180249,Great Falls College Montana State University,1875,1222,892,983
170091,Great Lakes Christian College,194,163,143,51
213181,Great Lakes Institute of Technology,453,453,453,0
202949,Great Oaks Institute of Technology and Career Development,289,289,289,0
364548,Great Plains Technology Center,296,275,265,31
383367,Greater Altoona Career & Technology Center,264,239,226,38
418454,Greater Johnstown Career and Technology Center,228,205,193,35
382416,Greater Lowell Technical School,80,80,80,0
428019,Green Country Technology Center,310,146,63,247
230898,Green Mountain College,840,827,819,21
235343,Green River Community College,7801,5954,5021,2780
260363,Greene County Career and Technology Center,35,35,35,0
365240,Greene County Vocational School District,171,134,115,56
165981,Greenfield Community College,2240,1293,815,1425
198598,Greensboro College,1012,871,781,231
145372,Greenville College,1368,1221,1129,239
218113,Greenville Technical College,13448,8137,5452,7996
153384,Grinnell College,1721,1686,1664,57
115296,Grossmont College,18618,10671,6654,11964
212805,Grove City College,2491,2459,2438,53
240745,Guam Community College,2603,1552,1021,1582
198613,Guilford College,2302,2075,1928,374
198622,Guilford Technical Community College,13656,9118,6825,6831
134343,Gulf Coast State College,6271,3857,2224,4047
139995,Gupton Jones College of Funeral Service,174,174,174,0
459213,Gurnick Academy of Medical Arts,843,813,794,49
173647,Gustavus Adolphus College,2449,2433,2423,26
132666,GUTI The Premier Beauty & Wellness Academy,129,129,129,0
159027,Guy's Shreveport Academy of Cosmetology Inc,62,62,62,0
140003,Gwinnett College-Lilburn,368,247,168,200
425250,Gwinnett College-Sandy Springs,108,69,43,65
140012,Gwinnett Technical College,7180,3926,2282,4898
212832,Gwynedd Mercy University,2371,2143,1998,373
102313,H Councill Trenholm State Technical College,1351,926,711,640
383084,Hacienda La Puente Adult Education,4151,2512,1684,2467
162690,Hagerstown Community College,4905,2468,1236,3669
462026,Hair Academy,13,13,13,0
448008,Hair Academy 110,20,20,20,0
436030,Hair Academy II,39,23,13,26
163541,Hair Academy Inc-New Carrollton,374,299,249,125
105701,Hair Academy of Safford,64,64,64,0
454944,Hair Academy Paul Mitchell Partner School,139,128,120,19
367088,Hair Arts Academy,74,74,74,0
114628,Hair California Beauty Academy,47,34,26,21
474933,Hair Design Institute,67,47,34,33
474942,Hair Design Institute,122,100,86,36
189404,Hair Design Institute at Fifth Avenue-Brooklyn,200,165,142,58
460446,Hair Design Institute at Fifth Avenue-New York,224,184,157,67
127228,Hair Dynamics Education Center,174,174,174,0
447971,Hair Expressions Academy,45,45,45,0
150710,Hair Fashions By Kaye Beauty College-Indianapolis,108,108,108,0
150695,Hair Fashions By Kaye Beauty College-Noblesville,70,70,70,0
145406,Hair Professionals Academy of Cosmetology,218,132,76,142
367981,Hair Professionals Career College,87,56,36,51
145424,Hair Professionals Career College,81,49,28,53
145433,Hair Professionals School of Cosmetology,92,61,40,52
421610,Hairitage Hair Academy,53,42,35,18
367051,Hairmasters Institute of Cosmetology,111,79,58,53
198640,Halifax Community College,1353,911,688,665
225201,Hallmark College,735,735,735,0
166009,Hallmark Institute of Photography,69,69,69,0
191515,Hamilton College,1926,1913,1905,21
431202,Hamilton Fulton Montgomery BOCES-Practical Nursing Program,69,23,0,69
153427,Hamilton Technical College,177,177,177,0
173665,Hamline University,4581,3387,2647,1934
232256,Hampden-Sydney College,1070,1069,1068,2
166018,Hampshire College,1492,1492,1492,0
232265,Hampton University,4622,4312,4116,506
369950,Hamrick School,187,187,187,0
455327,Hands on Therapy,72,46,29,43
202985,Hannah E Mullins School of Practical Nursing,77,77,77,0
177542,Hannibal-LaGrange University,1229,1019,883,346
150756,Hanover College,1163,1160,1158,5
418506,Hanover Public School District Practical Nursing Program,36,36,36,0
212869,Harcum College,1627,1272,1039,588
225247,Hardin-Simmons University,2220,1958,1792,428
107044,Harding University,6238,5365,4820,1418
162706,Harford Community College,6992,4075,2601,4391
481270,Harmon's Beauty School,13,12,11,2
452984,Harmony Path School of Massage Therapy,16,6,0,16
149842,Harper College,14830,8660,5541,9289
145460,Harrington College of Design,600,363,213,387
184870,Harris School of Business-Cherry Hill Campus,346,285,245,101
444200,Harris School of Business-Dover Campus,438,385,350,88
453552,Harris School of Business-Hamilton Campus,352,284,239,113
448983,Harris School of Business-Linwood Campus,441,370,323,118
460598,Harris School of Business-Upper Darby Campus,594,522,475,119
185332,Harris School of Business-Voorhees Campus,422,353,308,114
441362,Harris School of Business-Wilmington Campus,480,402,351,129
177551,Harris-Stowe State University,1298,1111,984,314
212878,Harrisburg Area Community College-Harrisburg,20780,11298,6506,14274
446640,Harrisburg University of Science and Technology,344,305,281,63
458432,Harrison College-Grove City,244,198,168,76
151166,Harrison College-Indianapolis,3726,2918,2395,1331
468398,Harrison College-Morrisville,203,178,161,42
129491,Hartford Seminary,123,69,36,87
115393,Hartnell College,9439,5436,3413,6026
191533,Hartwick College,1618,1594,1579,39
166027,Harvard University,28297,23434,20370,7927
115409,Harvey Mudd College,807,806,805,2
155140,Haskell Indian Nations University,742,729,721,21
417600,Hastings Beauty School,39,39,39,0
181127,Hastings College,1144,1103,1076,68
212911,Haverford College,1187,1187,1187,0
449579,Hawaii College of Oriental Medicine,11,11,11,0
383190,Hawaii Community College,3406,2205,1598,1808
141608,Hawaii Institute of Hair Design,85,85,85,0
460756,Hawaii Medical College,426,426,426,0
141644,Hawaii Pacific University,6736,5287,4359,2377
153445,Hawkeye Community College,5809,3988,3068,2741
155159,Hays Academy of Hair Design,77,77,77,0
478917,Hays Academy of Hair Design,63,63,63,0
198668,Haywood Community College,2290,1431,997,1293
156790,Hazard Community and Technical College,3790,2471,1805,1985
173683,Hazelden Graduate School of Addiction Studies,90,70,58,32
418612,Hazleton Area Career Center,26,26,26,0
439668,HDS Truck Driving Institute,120,120,120,0
219125,Headlines Academy Inc,81,81,81,0
247010,Headmasters School of Hair Design,41,41,41,0
200129,Headquarters Academy of Hair Design Inc,53,53,53,0
248165,Heads West Kentucky Beauty College,62,49,40,22
115533,Heald College-Concord,1503,1266,1110,393
115472,Heald College-Fresno,1791,1520,1342,449
371779,Heald College-Hayward,1249,992,823,426
141468,Heald College-Honolulu,1678,1400,1217,461
459930,Heald College-Modesto,1091,988,920,171
430148,Heald College-Portland,682,587,525,157
115454,Heald College-Rancho Cordova,1150,992,888,262
363387,Heald College-Roseville,1256,1050,914,342
409874,Heald College-Salinas,1076,884,758,318
115515,Heald College-San Francisco,1074,844,693,381
115490,Heald College-San Jose,1671,1368,1169,502
371760,Heald College-Stockton,1418,1173,1011,407
455071,Healing Arts Center,119,47,0,119
444635,Healing Arts Institute,48,19,0,48
381866,Healing Arts Institute,50,50,50,0
454795,Healing Hands School of Holistic Health,228,161,117,111
441830,Healing Mountain Massage School,67,40,23,44
448017,Healing Touch Career College,134,134,134,0
456968,Health And Style Institute,179,162,151,28
444644,Health Works Institute,36,36,36,0
446303,Healthcare Training Institute,68,47,34,34
481465,Healthcare Training Institute,31,26,23,8
384342,Heartland Community College,5215,3239,2241,2974
166045,Hebrew College,188,114,69,119
145497,Hebrew Theological College,522,470,436,86
203067,Hebrew Union College-Jewish Institute of Religion,359,295,256,103
203085,Heidelberg University,1241,1151,1094,147
180276,Helena College University of Montana,1430,925,670,760
191597,Helene Fuld College of Nursing,396,289,220,176
166054,Hellenic College-Holy Cross Greek Orthodox School of Theology,208,203,200,8
481155,Helms College,127,127,127,0
156851,Henderson Community College,2036,1041,538,1498
107071,Henderson State University,3583,3194,2953,630
107080,Hendrix College,1444,1438,1434,10
173708,Hennepin Technical College,6402,3663,2278,4124
431266,Henrico County-Saint Marys Hospital School of Practical Nursing,91,54,35,56
166063,Henris School of Hair Design,30,30,30,0
170240,Henry Ford Community College,13836,7974,5011,8825
198677,Heritage Bible College,67,57,50,17
101453,Heritage Christian University,94,57,33,61
469054,Heritage College-Columbus,520,520,520,0
262509,Heritage College-Denver,466,466,466,0
445814,Heritage College-Kansas City,616,616,616,0
456339,Heritage College-Little Rock,413,413,413,0
410070,Heritage College-Oklahoma City,722,722,722,0
456320,Heritage College-Wichita,390,390,390,0
135124,Heritage Institute-Ft Myers,614,614,614,0
372772,Heritage Institute-Jacksonville,279,279,279,0
235422,Heritage University,1128,878,719,409
431275,Herkimer County BOCES-Practical Nursing Program,123,62,31,92
191612,Herkimer County Community College,3212,2459,2079,1133
430643,Herndon Career Center,6,2,0,6
140340,Herzing University-Atlanta,459,377,324,135
101365,Herzing University-Birmingham,320,223,160,160
459851,Herzing University-Brookfield,343,293,261,82
433536,Herzing University-Kenner,329,247,194,135
459842,Herzing University-Kenosha,435,313,234,201
240392,Herzing University-Madison,2680,1819,1265,1415
174154,Herzing University-Minneapolis,262,181,128,134
457022,Herzing University-Toledo,205,164,137,68
386472,Herzing University-Winter Park,378,304,256,122
155177,Hesston College,445,403,376,69
173735,Hibbing Community College,1376,1023,845,531
177579,Hickey College,372,339,318,54
208053,High Plains Technology Center,257,115,43,214
198695,High Point University,4199,4087,4017,182
155186,Highland Community College,3226,1866,1178,2048
145521,Highland Community College,2031,1379,1050,981
180081,Highlands College of Montana Tech,913,658,529,384
235431,Highline Community College,6612,4835,3937,2675
191621,Hilbert College,1070,984,928,142
225371,Hill College,4495,2790,1928,2567
134495,Hillsborough Community College,26590,16588,11532,15058
168555,Hillsdale Beauty College,35,34,33,2
207157,Hillsdale Free Will Baptist College,202,182,169,33
115658,Hilltop Beauty School,126,61,18,108
178466,Hillyard Technical Center,154,150,148,6
175786,Hinds Community College,11893,9618,8468,3425
480000,Hinton Barber College,56,49,44,12
203128,Hiram College,1311,1193,1117,194
242413,Hispanic American College,266,266,266,0
220312,Hiwassee College,364,269,207,157
203146,Hobart Institute of Welding Technology,285,285,285,0
191630,Hobart William Smith Colleges,2372,2345,2328,44
134510,Hobe Sound Bible College,200,136,95,105
203155,Hocking College,4094,3375,3012,1082
367884,Hodges University,2078,1618,1323,755
191649,Hofstra University,10928,9978,9383,1545
184746,Hohokus School of Trade and Technical Sciences,255,204,171,84
185721,Hohokus School-RETS Nutley,579,579,579,0
461379,Holistic Massage Training Institute,18,7,0,18
232308,Hollins University,750,667,616,134
457280,Hollywood Beauty College,115,95,82,33
207166,Hollywood Cosmetology Center,17,17,17,0
134529,Hollywood Institute of Beauty Careers,73,73,73,0
460631,Hollywood Institute of Beauty Careers,53,53,53,0
175810,Holmes Community College,5911,4673,4048,1863
129534,Holy Apostles College and Seminary,385,223,123,262
150774,Holy Cross College,524,507,496,28
212984,Holy Family University,2956,2096,1553,1403
184968,Holy Name Medical Center School of Nursing,150,116,93,57
115728,Holy Names University,1343,1026,827,516
166133,Holyoke Community College,6740,4436,3272,3468
457086,Homestead Schools,166,136,117,49
203386,Hondros College,1656,1426,1278,378
141680,Honolulu Community College,4368,2551,1632,2736
162760,Hood College,2392,1784,1406,986
443076,Hood Theological Seminary,181,159,146,35
170301,Hope College,3388,3295,3235,153
120537,Hope International University,1356,1099,935,421
156860,Hopkinsville Community College,3609,2292,1627,1982
457226,Horizon University,58,32,16,42
218140,Horry-Georgetown Technical College,7660,4505,2911,4749
107099,Hot Springs Beauty College,43,43,43,0
191676,Houghton College,1100,1059,1032,68
421665,Houghton Lake Institute of Cosmetology,14,9,6,8
129543,Housatonic Community College,5813,3176,1843,3970
176716,House of Heavilin Beauty College-Blue Springs,90,90,90,0
177588,House of Heavilin Beauty College-Kansas City,38,38,38,0
421771,House of Heavilin Beauty College-Raymore,51,51,51,0
225399,Houston Baptist University,2910,2544,2315,595
225423,Houston Community College,57978,31241,17728,40250
246345,Houston Graduate School of Theology,174,121,88,86
383792,Houston Training School-Gulfgate,277,277,277,0
380067,Houston Training School-Main Campus,177,177,177,0
468875,Houston Training Schools-Southwest,205,205,205,0
225520,Howard College,4130,2114,1095,3035
162779,Howard Community College,9969,5799,3691,6278
225548,Howard Payne University,1170,1079,1020,150
131520,Howard University,10297,9577,9123,1174
417248,Howell Cheney Technical High School,41,41,41,0
184995,Hudson County Community College,9036,7063,6066,2970
191719,Hudson Valley Community College,12841,8849,6832,6009
242112,Huertas College,1255,1139,1062,193
164368,Hult International Business School,641,641,641,0
242121,Humacao Community College,705,555,458,247
115755,Humboldt State University,8293,7892,7631,662
115773,Humphreys College-Stockton and Modesto Campuses,990,702,517,473
191728,Hunter Business School,964,755,618,346
101435,Huntingdon College,1110,984,902,208
440217,Huntingdon County Career and Technology Center,34,34,34,0
237437,Huntington Junior College,685,623,583,102
377643,Huntington School of Beauty Culture-Main Campus,125,125,125,0
150941,Huntington University,1124,1042,990,134
449348,Huntsville Bible College,45,29,18,27
212993,Hussian School of Art,86,86,86,0
161165,Husson University,3049,2584,2288,761
225575,Huston-Tillotson University,973,892,840,133
155195,Hutchinson Community College,6127,3632,2371,3756
368771,Hypnosis Motivation Institute,111,111,111,0
372329,IBMC College,258,258,258,0
193405,Icahn School of Medicine at Mount Sinai,1090,1090,1090,0
391810,ICC Technical Institute,56,56,56,0
437662,ICDC College,3265,3106,3002,263
242130,ICPR Junior College-Arecibo,542,516,499,43
243841,ICPR Junior College-General Institutional,789,722,678,111
460677,ICPR Junior College-Manati,613,541,493,120
242149,ICPR Junior College-Mayaguez,596,540,503,93
142276,Idaho State University,13326,10258,8231,5095
480161,Ideal Beauty Academy,9,8,7,2
449597,Ideal Beauty Academy,33,27,23,10
127273,Iliff School of Theology,349,246,182,167
434584,Ilisagvik College,257,119,50,207
419253,Illinois Center for Broadcasting,170,170,170,0
460145,Illinois Center for Broadcasting–Chicago Campus,220,220,220,0
145682,Illinois Central College,10770,6251,3967,6803
145691,Illinois College,1028,999,981,47
145628,Illinois College of Optometry,636,636,636,0
145725,Illinois Institute of Technology,7850,7042,6539,1311
411374,Illinois School of Health Careers-Chicago Campus,612,612,612,0
448406,Illinois School of Health Careers-O'Hare Campus,175,175,175,0
145813,Illinois State University,20272,18780,17864,2408
145831,Illinois Valley Community College,3705,2240,1499,2206
145646,Illinois Wesleyan University,2009,2004,2001,8
106908,Imagine-Paul Mitchell Partner School,482,424,385,97
213011,Immaculata University,3675,2253,1349,2326
457387,Immokalee Technical Center,386,254,187,199
115861,Imperial Valley College,7701,5131,3832,3869
444653,In Session Arts of Cosmetology Beauty School,77,60,49,28
177603,Independence College of Cosmetology,64,56,50,14
155201,Independence Community College,1031,728,575,456
465812,Independence University,1280,1280,1280,0
418296,Indian Capital Technology Center-Muskogee,759,369,172,587
421540,Indian Capital Technology Center-Sallisaw,218,114,62,156
421559,Indian Capital Technology Center-Stilwell,145,87,58,87
208026,Indian Capital Technology Center-Tahlequah,229,146,104,125
153472,Indian Hills Community College,4604,3250,2565,2039
134608,Indian River State College,17248,10503,5940,11308
418560,Indiana County Technology Center,105,61,39,66
151290,Indiana Institute of Technology,6307,4913,4016,2291
151324,Indiana State University,12448,10976,10068,2380
213020,Indiana University of Pennsylvania-Main Campus,14925,13704,12965,1960
151351,Indiana University-Bloomington,46817,41092,37467,9350
151388,Indiana University-East,4456,2994,2009,2447
151333,Indiana University-Kokomo,4178,2910,2063,2115
151360,Indiana University-Northwest,6387,4566,3358,3029
151102,Indiana University-Purdue University-Fort Wayne,13459,9910,7537,5922
151111,Indiana University-Purdue University-Indianapolis,30488,24730,21097,9391
151342,Indiana University-South Bend,8073,5674,4083,3990
151379,Indiana University-Southeast,6733,4898,3695,3038
151801,Indiana Wesleyan University,14959,13960,13321,1638
415057,Industrial Management Training Institute,117,117,117,0
444671,Industrial Technical College,258,258,258,0
439400,Infinity Career College,66,49,38,28
245290,Infinity Career College,112,90,75,37
450960,InfoTech Career College,181,181,181,0
451635,Inland Massage Institute,25,25,25,0
388663,Inner State Beauty School,139,139,139,0
457554,Innovations Design Academy,45,43,42,3
376288,Institucion Chaviano de Mayaguez,82,82,82,0
115931,Institute for Business and Technology,173,173,173,0
145886,Institute for Clinical Social Work,129,121,116,13
462044,Institute for Doctoral Studies in the Visual Arts,46,37,32,14
445869,Institute for the Psychological Sciences,80,79,78,2
441548,Institute for Therapeutic Massage,139,139,139,0
458122,Institute of Advanced Medical Esthetics,1,1,1,0
451422,Institute of Allied Medical Professions-New York,110,110,110,0
187745,Institute of American Indian and Alaska Native Culture,422,285,192,230
191834,Institute of Audio Research,490,454,431,59
240879,Institute of Beauty Careers,156,156,156,0
444680,Institute of Beauty Occupation and Technology Course,52,52,52,0
444699,Institute of Clinical Acupuncture & Oriental Med,53,50,48,5
457819,Institute of Culinary Education,614,252,13,601
191764,Institute of Design and Construction,103,67,43,60
448141,Institute of Hair Design,39,39,39,0
444705,Institute of Hair Design,19,19,19,0
481207,Institute of Health Sciences,55,55,55,0
461218,Institute of Medical Careers,54,53,52,2
454616,Institute of Production and Recording,242,188,153,89
448044,Institute of Professional Careers,7,7,7,0
454838,Institute of Taoist Education and Acupuncture,43,43,43,0
441441,Institute of Technical Arts,263,263,263,0
431141,Institute of Technology Inc,1989,1973,1962,27
441663,Institute of Technology Inc,335,316,304,31
453075,Institute of Therapeutic Massage,66,65,64,2
455804,Institute of World Politics,135,100,79,56
242422,Instituto de Banca y Comercio Inc,16339,16339,16339,0
447528,Instituto de Educacion Tecnica Ocupacional La Reine-Aguadilla,138,138,138,0
242316,Instituto de Educacion Tecnica Ocupacional La Reine-Manati,335,335,335,0
451501,Instituto Educativo Premier,125,125,125,0
242556,Instituto Tecnologico de Puerto Rico-Recinto de Guayama,861,803,773,88
242042,Instituto Tecnologico de Puerto Rico-Recinto de Manati,755,676,636,119
242565,Instituto Tecnologico de Puerto Rico-Recinto de Ponce,644,610,593,51
242583,Instituto Tecnologico de Puerto Rico-Recinto de San Juan,650,578,542,108
128179,Intellitec College-Colorado Springs,815,815,815,0
128188,Intellitec College-Grand Junction,536,536,536,0
127839,Intellitec Medical Institute,339,339,339,0
242626,Inter American University of Puerto Rico-Aguadilla,4595,4196,3938,657
242635,Inter American University of Puerto Rico-Arecibo,4799,4326,4022,777
242644,Inter American University of Puerto Rico-Barranquitas,2073,1940,1854,219
242705,Inter American University of Puerto Rico-Bayamon,4857,4439,4169,688
242680,Inter American University of Puerto Rico-Fajardo,2259,2042,1902,357
242699,Inter American University of Puerto Rico-Guayama,2169,1972,1844,325
242653,Inter American University of Puerto Rico-Metro,9853,8553,7725,2128
242662,Inter American University of Puerto Rico-Ponce,5821,5306,4974,847
242617,Inter American University of Puerto Rico-San German,5177,4728,4443,734
242723,Inter American University of Puerto Rico-School of Law,803,589,457,346
404222,Inter American University of Puerto Rico-School of Optometry,221,219,217,4
138655,Interactive College of Technology-Chamblee,383,379,377,6
442435,Interactive College of Technology-Gainesville,39,39,39,0
138664,Interactive College of Technology-Morrow,36,36,36,0
367103,Interactive College of Technology-Newport,30,30,30,0
367361,Interactive Learning Systems-Houston,31,30,30,1
443696,Interactive Learning Systems-North Houston,25,25,25,0
440776,Interactive Learning Systems-Pasadena,30,30,30,0
480356,InterCoast Career Institute-Salem,34,34,34,0
450678,InterCoast Career Institute-South Portland,101,101,101,0
437884,InterCoast Colleges-Burbank,30,30,30,0
450669,InterCoast Colleges-Carson,33,33,33,0
457208,InterCoast Colleges-Elk Grove,28,28,28,0
481960,InterCoast Colleges-Fairfield,118,118,118,0
366289,InterCoast Colleges-Orange,134,134,134,0
442888,InterCoast Colleges-Riverside,84,84,84,0
458195,InterCoast Colleges-Roseville,3,3,3,0
443571,InterCoast Colleges-West Covina,37,37,37,0
140146,Interdenominational Theological Center,562,332,190,372
235495,Interface College-Spokane,49,49,49,0
116226,Interior Designers Institute,296,159,70,226
134714,International Academy,257,165,104,153
146010,International Academy of Design and Technology-Chicago,346,288,250,96
446792,International Academy of Design and Technology-Henderson,447,384,344,103
446817,International Academy of Design and Technology-Nashville,117,95,80,37
456296,International Academy of Design and Technology-Online,1251,1167,1112,139
440925,International Academy of Design and Technology-Orlando,348,312,289,59
450447,International Academy of Design and Technology-Sacramento,194,159,136,58
450465,International Academy of Design and Technology-San Antonio,356,309,279,77
446808,International Academy of Design and Technology-Seattle,384,332,298,86
134680,International Academy of Design and Technology-Tampa,474,427,397,77
445124,International Academy of Design and Technology-Troy,351,295,259,92
104911,International Academy of Hair Design,210,210,210,0
457785,International Academy of Style,118,118,118,0
235501,International Air and Hospitality Academy,266,266,266,0
436614,International Baptist College and Seminary,61,43,32,29
443359,International Barber & Style College,107,103,100,7
431284,International Beauty College,55,29,12,43
164100,International Beauty School,193,193,193,0
238005,International Beauty School 4,70,70,70,0
225779,International Business College-El Paso,196,179,167,29
225788,International Business College-El Paso,195,144,111,84
151458,International Business College-Fort Wayne,406,406,406,0
151467,International Business College-Indianapolis,399,399,399,0
462336,International College of Beauty Arts & Sciences,35,19,9,26
203289,International College of Broadcasting,74,74,74,0
461175,International College of Cosmetology,179,134,104,75
455053,International Cosmetology Academy,47,22,6,41
453297,International Culinary Arts and Sciences Institute,40,40,40,0
475097,International Culinary Center-California,124,96,78,46
448691,International Institute for Restorative Practices,30,11,0,30
457341,International Institute of Cosmetology,132,121,113,19
454704,International Polytechnic Institute,33,33,33,0
454740,International Professional School of Bodywork,215,113,46,169
127316,International Salon and Spa Academy,205,163,136,69
113449,International School of Beauty Inc,229,229,229,0
480347,International School of Cosmetology-Toni & Guy Hairdressing Academy,70,70,70,0
365091,International School of Skin Nailcare & Massage Therapy,328,328,328,0
242750,International Technical College,102,102,102,0
443128,International Technological University,1342,1089,932,410
439686,International Training Careers,280,245,222,58
437237,International Yacht Restoration School,71,71,71,0
173799,Inver Hills Community College,5944,3393,2104,3840
191931,Iona College,4241,3719,3389,852
153524,Iowa Central Community College,5697,3904,2998,2699
153533,Iowa Lakes Community College,2574,1756,1343,1231
153597,Iowa School of Beauty-Des Moines,150,150,150,0
153171,Iowa School of Beauty-Marshalltown,34,34,34,0
154165,Iowa School of Beauty-Ottumwa,63,63,63,0
154457,Iowa School of Beauty-Sioux City,54,54,54,0
153603,Iowa State University,32955,30747,29398,3557
153621,Iowa Wesleyan College,599,528,482,117
153630,Iowa Western Community College,6861,4622,3490,3371
441238,Irell & Manella Graduate School of Biological Sciences at City of Hope,82,82,82,0
443137,Irene's Myomassology Institute,353,353,353,0
116439,Irvine Valley College,13362,7472,4495,8867
191940,Isabella Graham Hart School of Practical Nursing,76,66,60,16
191959,Island Drafting and Technical Institute,95,95,95,0
198710,Isothermal Community College,2390,1509,1064,1326
173805,Itasca Community College,1248,1008,886,362
175829,Itawamba Community College,5693,4697,4194,1499
191968,Ithaca College,6723,6625,6562,161
159197,ITI Technical College,630,630,630,0
459611,ITT Technical Institute-Akron,249,220,201,48
434566,ITT Technical Institute-Albany,253,222,201,52
369084,ITT Technical Institute-Albuquerque,476,399,350,126
225849,ITT Technical Institute-Arlington,612,543,498,114
260974,ITT Technical Institute-Arlington Heights,248,215,193,55
434548,ITT Technical Institute-Arnold,291,241,208,83
450243,ITT Technical Institute-Atlanta,483,399,345,138
459675,ITT Technical Institute-Aurora,247,217,198,49
366678,ITT Technical Institute-Austin,432,381,348,84
450216,ITT Technical Institute-Baton Rouge,656,592,551,105
414568,ITT Technical Institute-Bessemer,538,446,386,152
142337,ITT Technical Institute-Boise,251,204,174,77
470852,ITT Technical Institute-Bradenton,66,54,47,19
470870,ITT Technical Institute-Brooklyn Center,159,143,132,27
442338,ITT Technical Institute-Canton,442,358,303,139
451936,ITT Technical Institute-Cary,282,252,232,50
459620,ITT Technical Institute-Cedar Rapids,37,28,23,14
441964,ITT Technical Institute-Chantilly,573,507,465,108
456445,ITT Technical Institute-Charlotte North,416,358,321,95
448442,ITT Technical Institute-Charlotte South,369,316,282,87
450261,ITT Technical Institute-Chattanooga,206,177,158,48
451954,ITT Technical Institute-Clive,208,175,154,54
448451,ITT Technical Institute-Clovis,439,386,351,88
450225,ITT Technical Institute-Columbia,357,309,278,79
451963,ITT Technical Institute-Columbus,345,307,283,62
456427,ITT Technical Institute-Concord,258,228,208,50
413884,ITT Technical Institute-Cordova,552,461,402,150
459639,ITT Technical Institute-Corona,479,435,407,72
459693,ITT Technical Institute-Culver City,319,274,245,74
203313,ITT Technical Institute-Dayton,304,256,225,79
459709,ITT Technical Institute-Dearborn,438,360,309,129
479619,ITT Technical Institute-Deerfield Beach,72,61,54,18
459657,ITT Technical Institute-DeSoto,187,167,154,33
479637,ITT Technical Institute-Douglasville,155,142,133,22
443526,ITT Technical Institute-Duluth,591,517,469,122
448460,ITT Technical Institute-Dunmore,186,162,147,39
462363,ITT Technical Institute-Durham,168,133,111,57
176637,ITT Technical Institute-Earth City,602,529,481,121
445081,ITT Technical Institute-Eden Prairie,208,172,148,60
414531,ITT Technical Institute-Everett,271,228,201,70
409069,ITT Technical Institute-Fort Lauderdale,531,443,386,145
456436,ITT Technical Institute-Fort Myers,339,269,224,115
151500,ITT Technical Institute-Fort Wayne,283,230,196,87
479567,ITT Technical Institute-Germantown,50,46,44,6
420404,ITT Technical Institute-Getzville,381,331,298,83
479576,ITT Technical Institute-Grand Rapids,51,47,44,7
440165,ITT Technical Institute-Green Bay,181,148,126,55
238892,ITT Technical Institute-Greenfield,448,383,341,107
413866,ITT Technical Institute-Greenville,353,312,285,68
462372,ITT Technical Institute-Hanover,313,283,264,49
430351,ITT Technical Institute-Harrisburg,239,207,186,53
429599,ITT Technical Institute-Henderson,469,402,359,110
451990,ITT Technical Institute-High Point,451,370,318,133
443535,ITT Technical Institute-Hilliard,322,261,222,100
366696,ITT Technical Institute-Houston North,650,604,575,75
225858,ITT Technical Institute-Houston West,609,573,550,59
456418,ITT Technical Institute-Huntington,263,226,202,61
151519,ITT Technical Institute-Indianapolis,4397,3168,2375,2022
479628,ITT Technical Institute-Indianapolis East,337,290,260,77
407063,ITT Technical Institute-Jacksonville,591,500,441,150
459648,ITT Technical Institute-Johnson City,139,123,112,27
446899,ITT Technical Institute-Kansas City,362,324,300,62
446905,ITT Technical Institute-Kennesaw,351,307,278,73
366650,ITT Technical Institute-Knoxville,400,336,294,106
372578,ITT Technical Institute-Lake Mary,269,217,183,86
459718,ITT Technical Institute-Las Vegas,569,489,438,131
437219,ITT Technical Institute-Lathrop,492,445,415,77
440642,ITT Technical Institute-Levittown,380,338,311,69
448488,ITT Technical Institute-Lexington,242,205,181,61
413839,ITT Technical Institute-Little Rock,289,257,236,53
434575,ITT Technical Institute-Liverpool,278,245,223,55
413857,ITT Technical Institute-Louisville,547,443,376,171
456393,ITT Technical Institute-Madison,231,203,185,46
451981,ITT Technical Institute-Madison,178,149,130,48
451945,ITT Technical Institute-Madison,372,308,267,105
479558,ITT Technical Institute-Marlton,312,286,269,43
448497,ITT Technical Institute-Maumee,219,190,172,47
459587,ITT Technical Institute-Merrillville,357,288,243,114
430263,ITT Technical Institute-Miami,417,343,295,122
450252,ITT Technical Institute-Mobile,690,582,512,178
230384,ITT Technical Institute-Murray,471,392,341,130
470904,ITT Technical Institute-Myrtle Beach,216,194,179,37
151494,ITT Technical Institute-Nashville,525,438,381,144
116466,ITT Technical Institute-National City,1209,1120,1063,146
251251,ITT Technical Institute-Newburgh,295,235,197,98
368601,ITT Technical Institute-Norfolk,720,634,578,142
459666,ITT Technical Institute-North Charleston,265,238,221,44
430379,ITT Technical Institute-Norwood,419,351,307,112
366580,ITT Technical Institute-Norwood,478,411,368,110
434557,ITT Technical Institute-Oak Brook,336,287,255,81
467058,ITT Technical Institute-Oakland,169,147,132,37
448503,ITT Technical Institute-Oklahoma City,408,314,253,155
407319,ITT Technical Institute-Omaha,505,407,344,161
116484,ITT Technical Institute-Orange,823,720,653,170
414586,ITT Technical Institute-Orland Park,527,393,306,221
470889,ITT Technical Institute-Orlando,377,318,280,97
479646,ITT Technical Institute-Overland Park,171,142,123,48
446914,ITT Technical Institute-Owings Mills,616,504,432,184
413848,ITT Technical Institute-Oxnard,312,281,261,51
481614,ITT Technical Institute-Pensacola,165,156,150,15
479549,ITT Technical Institute-Philadelphia,559,523,499,60
451972,ITT Technical Institute-Phoenix,247,201,171,76
470861,ITT Technical Institute-Phoenix West,262,233,214,48
414841,ITT Technical Institute-Pittsburgh,224,190,168,56
442347,ITT Technical Institute-Plymouth Meeting,310,256,220,90
208965,ITT Technical Institute-Portland,605,491,418,187
108250,ITT Technical Institute-Rancho Cordova,510,435,387,123
434052,ITT Technical Institute-Richardson,652,541,469,183
437051,ITT Technical Institute-Richmond,573,515,477,96
437042,ITT Technical Institute-Saint Rose,470,426,397,73
459602,ITT Technical Institute-Salem,250,206,177,73
479600,ITT Technical Institute-Salem,191,174,163,28
377069,ITT Technical Institute-San Antonio,585,508,459,126
481623,ITT Technical Institute-San Antonio East,170,163,158,12
381909,ITT Technical Institute-San Bernardino,730,655,606,124
116475,ITT Technical Institute-San Dimas,534,482,449,85
235510,ITT Technical Institute-Seattle,444,388,352,92
450270,ITT Technical Institute-South Bend,330,269,230,100
479585,ITT Technical Institute-Southfield,143,127,117,26
235529,ITT Technical Institute-Spokane Valley,297,262,239,58
441955,ITT Technical Institute-Springfield,678,567,495,183
479655,ITT Technical Institute-Springfield,202,185,174,28
456409,ITT Technical Institute-Springfield,206,177,158,48
450207,ITT Technical Institute-St Petersburg,230,189,163,67
430388,ITT Technical Institute-Strongsville,391,330,291,100
448479,ITT Technical Institute-Swartz Creek,402,322,270,132
244011,ITT Technical Institute-Sylmar,557,483,435,122
459596,ITT Technical Institute-Tallahassee,368,298,252,116
134909,ITT Technical Institute-Tampa,463,373,314,149
430360,ITT Technical Institute-Tarentum,255,221,199,56
105172,ITT Technical Institute-Tempe,498,434,392,106
378406,ITT Technical Institute-Torrance,457,398,360,97
261472,ITT Technical Institute-Troy,581,466,392,189
105163,ITT Technical Institute-Tucson,409,346,305,104
448512,ITT Technical Institute-Tulsa,519,424,362,157
470898,ITT Technical Institute-Waco,231,211,198,33
446923,ITT Technical Institute-Warrensville Heights,458,389,344,114
427663,ITT Technical Institute-Webster,303,279,264,39
479664,ITT Technical Institute-West Chester,61,52,46,15
459684,ITT Technical Institute-West Covina,148,129,117,31
479594,ITT Technical Institute-West Palm Beach,274,241,220,54
244154,ITT Technical Institute-Westminster,218,189,170,48
450234,ITT Technical Institute-Wichita,303,244,206,97
439136,ITT Technical Institute-Wilmington,403,348,313,90
170417,ITT Technical Institute-Wyoming,343,299,270,73
206631,ITT Technical Institute-Youngstown,472,411,372,100
438984,IVAEM College,161,159,157,4
364593,Iverson Business School,2,2,2,0
452841,Iverson Institute,134,134,134,0
150987,Ivy Tech Community College,98778,55889,34212,64566
151537,J Everett Light Career Center,40,40,40,0
101462,J F Drake State Community and Technical College,1383,886,635,748
101471,J F Ingram State Technical College,513,452,421,92
150765,J Michael Harrold Beauty Academy,86,86,86,0
462309,J Renee Career Facilitation,110,98,90,20
232414,J Sargeant Reynolds Community College,12454,6541,3552,8902
170444,Jackson College,5665,3489,2389,3276
220400,Jackson State Community College,4587,2882,2020,2567
175856,Jackson State University,9134,7604,6665,2469
441405,Jacksonville Beauty Institute,14,14,14,0
225876,Jacksonville College-Main Campus,524,368,266,258
101480,Jacksonville State University,8693,7038,5982,2711
134945,Jacksonville University,4157,3077,2388,1769
203678,James A Rhodes State College,3599,2144,1409,2190
101161,James H Faulkner State Community College,4362,3174,2573,1789
232423,James Madison University,20181,19226,18626,1555
237473,James Rumsey Technical Institute,129,129,129,0
198729,James Sprunt Community College,1291,896,697,594
213163,Jameson Health System,71,71,71,0
192004,Jamestown Business College,275,271,269,6
191986,Jamestown Community College,5178,3574,2764,2414
225885,Jarvis Christian College,609,585,569,40
443146,Jay's Technical Institute,128,98,79,49
414540,Jean Madeline Aveda Institute,278,251,233,45
177676,Jefferson College,5194,3547,2715,2479
231837,Jefferson College of Health Sciences,1039,947,888,151
156921,Jefferson Community and Technical College,13498,7612,4637,8861
192022,Jefferson Community College,3931,2804,2234,1697
418445,Jefferson County Dubois Area Vocational Technical Practical Nursing Program,34,34,34,0
101499,Jefferson Davis Community College,1091,777,618,473
417886,Jefferson Lewis BOCES-Practical Nursing Program,84,84,84,0
107123,Jefferson Regional Medical Center School of Nursing,76,76,76,0
101505,Jefferson State Community College,8542,4788,2891,5651
248192,Jenny Lea Academy of Cosmetology,28,20,15,13
156949,Jenny Lea Academy of Cosmetology,26,23,21,5
451918,Jenny Lea Academy of Cosmetology and Aesthetics,142,126,116,26
455196,Jersey College,1887,1887,1887,0
192040,Jewish Theological Seminary of America,446,365,314,132
419341,Jna Institute of Culinary Arts,65,65,65,0
185174,Joe Kubert School of Cartoon and Graphic Art,98,98,98,0
188696,Joffrey Ballet School,230,230,230,0
220464,John A Gupton College,122,92,72,50
146205,John A Logan College,7150,3789,2091,5059
107141,John Brown University,2596,2047,1698,898
101514,John C Calhoun State Community College,11186,6581,4254,6932
203368,John Carroll University,3711,3404,3213,498
446349,John D Rockefeller IV Career Center,3,3,3,0
116712,John F Kennedy University,1356,879,580,776
159319,John Jay Beauty College,36,36,36,0
159328,John Jay Beauty College,76,76,76,0
455239,John Paolo's Xtreme Beauty Institute-Goldwell Product Artistry,72,53,40,32
459471,John Paolo's Xtreme Beauty Institute-Goldwell Product Artistry,27,15,7,20
462354,John Paul the Great Catholic University,263,206,170,93
232450,John Tyler Community College,10103,5183,2697,7406
428125,John Wesley International Barber and Beauty College,89,88,87,2
146278,John Wood Community College,1923,1281,956,967
162928,Johns Hopkins University,20918,16186,13256,7662
445708,Johnson & Wales University-Charlotte,2325,2301,2286,39
439288,Johnson & Wales University-Denver,1529,1446,1393,136
414823,Johnson & Wales University-North Miami,1952,1920,1900,52
460349,Johnson & Wales University-Online,135,88,57,78
217235,Johnson & Wales University-Providence,10369,9897,9594,775
198756,Johnson C Smith University,1387,1348,1323,64
213233,Johnson College,427,414,405,22
155210,Johnson County Community College,19672,10810,6331,13341
230913,Johnson State College,1692,1268,993,699
220473,Johnson University,1031,925,859,172
132879,Johnson University Florida,302,259,232,70
198774,Johnston Community College,4235,2875,2187,2048
476832,Jolei's Hair Institute,41,37,34,7
210474,Jolie Hair and Beauty Academy-Hazleton,97,75,60,37
431099,Jolie Hair and Beauty Academy-Ludlow,102,80,65,37
478661,Jolie Hair and Beauty Academy-Northfield,214,165,133,81
213215,Jolie Hair and Beauty Academy-Wilkes-Barre,193,165,147,46
146296,Joliet Junior College,16869,9549,5849,11020
135063,Jones College-Jacksonville,449,215,64,385
175883,Jones County Junior College,4443,3865,3573,870
444723,Jones International University,2782,2060,1599,1183
373605,Jonesville Beauty School,36,36,36,0
461281,Jose Maria Vargas University,159,68,9,150
200165,Josef's School of Hair Design Inc-Fargo Downtown,63,63,63,0
456551,Josef's School of Hair Design Inc-Fargo West,42,42,42,0
200110,Josef's School of Hair Design Inc-Grand Forks,69,69,69,0
142407,Joseph Charles Institute of Cosmetology,57,43,34,23
215479,Joseph F McCloskey School of Nursing at Schuylkill Health,64,64,64,0
181190,Joseph's College,281,281,281,0
101541,Judson College,347,295,262,85
146339,Judson University,1170,979,856,314
461139,Jung Tao School of Classical Chinese Medicine,72,72,72,0
213251,Juniata College,1635,1592,1565,70
200387,JZ Trend Academy Paul Mitchell Partner School,56,56,56,0
481313,Kaizen Beauty Academy,34,33,33,1
170532,Kalamazoo College,1458,1451,1446,12
170541,Kalamazoo Valley Community College,10192,6004,3888,6304
445018,Kanawha Valley Community and Technical College,1573,1182,984,589
146348,Kankakee Community College,3825,2346,1599,2226
177746,Kansas City Art Institute,739,737,735,4
155292,Kansas City Kansas Community College,6570,3798,2397,4173
179812,Kansas City University of Medicine and Biosciences,1034,1033,1033,1
155399,Kansas State University,24581,22094,20549,4032
155414,Kansas Wesleyan University,729,665,624,105
141796,Kapiolani Community College,8376,4922,3176,5200
215646,Kaplan Career Institute-Broomall,519,519,519,0
206093,Kaplan Career Institute-Cleveland,302,302,302,0
458371,Kaplan Career Institute-Dearborn,36,36,36,0
211617,Kaplan Career Institute-Franklin Mills,718,718,718,0
251075,Kaplan Career Institute-Harrisburg,335,335,335,0
246202,Kaplan Career Institute-Nashville,323,323,323,0
214254,Kaplan Career Institute-Philadelphia,749,749,749,0
213002,Kaplan Career Institute-Pittsburgh,557,557,557,0
458690,Kaplan College-Arlington,422,422,422,0
447102,Kaplan College-Bakersfield,512,512,512,0
440323,Kaplan College-Beaumont,273,273,273,0
443827,Kaplan College-Brownsville,461,461,461,0
458706,Kaplan College-Charlotte,382,382,382,0
458186,Kaplan College-Chula Vista,299,299,299,0
443836,Kaplan College-Corpus Christi,370,370,370,0
382896,Kaplan College-Dallas,357,357,357,0
204626,Kaplan College-Dayton,404,404,404,0
246266,Kaplan College-El Paso,681,681,681,0
445328,Kaplan College-Fort Worth,282,282,282,0
447120,Kaplan College-Fresno,312,312,312,0
152415,Kaplan College-Hammond,366,366,366,0
152220,Kaplan College-Indianapolis,81,81,81,0
458283,Kaplan College-Indianapolis,478,478,478,0
458715,Kaplan College-Jacksonville,278,278,278,0
440332,Kaplan College-Laredo,329,329,329,0
374875,Kaplan College-Las Vegas,994,994,994,0
445346,Kaplan College-Lubbock,267,267,267,0
227836,Kaplan College-McAllen,540,540,540,0
366960,Kaplan College-Modesto,490,490,490,0
118967,Kaplan College-North Hollywood,792,792,792,0
447634,Kaplan College-Palm Springs,362,362,362,0
105118,Kaplan College-Phoenix,93,93,93,0
432302,Kaplan College-Riverside,234,234,234,0
118259,Kaplan College-Sacramento,547,547,547,0
431886,Kaplan College-San Antonio-Ingram,625,625,625,0
364955,Kaplan College-San Antonio-San Pedro,645,645,645,0
118277,Kaplan College-San Diego,1354,1354,1354,0
118286,Kaplan College-Vista,896,896,896,0
480064,Kaplan University-Augusta Campus,396,285,213,183
260910,Kaplan University-Cedar Falls Campus,449,360,302,147
153418,Kaplan University-Cedar Rapids Campus,512,394,318,194
260901,Kaplan University-Davenport Campus,52407,28382,12935,39472
367024,Kaplan University-Des Moines Campus,875,679,553,322
162681,Kaplan University-Hagerstown Campus,893,512,266,627
181242,Kaplan University-Lincoln Campus,501,397,330,171
160940,Kaplan University-Maine Campus,1017,690,478,539
153409,Kaplan University-Mason City Campus,228,179,148,80
181400,Kaplan University-Omaha Campus,795,642,544,251
146366,Kaskaskia College,5258,3062,1952,3306
141802,Kauai Community College,1530,895,574,956
166294,Kay Harvey Academy of Hair Design,46,28,16,30
374343,KC's School of Hair Design,76,76,76,0
225991,KD College Conservatory of Film and Dramatic Arts,153,153,153,0
185262,Kean University,14404,11763,10081,4323
440031,Keck Graduate Institute,169,162,157,12
182892,Keene Beauty Academy,54,52,50,4
183062,Keene State College,4923,4715,4580,343
192165,Kehilath Yakov Rabbinical Seminary,120,120,120,0
135081,Keiser University-Ft Lauderdale,17129,14166,12264,4865
170550,Kellogg Community College,6123,3214,1744,4379
146393,Kendall College,1659,1221,938,721
161192,Kennebec Valley Community College,2263,1201,664,1599
140164,Kennesaw State University,24629,20441,17690,6939
218195,Kenneth Shuler School of Cosmetology and Nails-Columbia,83,61,47,36
445850,Kenneth Shuler School of Cosmetology-Columbia,119,95,80,39
460011,Kenneth Shuler School of Cosmetology-Florence,146,127,114,32
467906,Kenneth Shuler School of Cosmetology-Greenville,175,149,132,43
218159,Kenneth Shuler School of Cosmetology-North Augusta,85,69,59,26
432117,Kenneth Shuler School of Cosmetology-Rock Hill,110,85,69,41
445841,Kenneth Shuler School of Cosmetology-Spartanburg,113,96,84,29
177816,Kenrick Glennon Seminary,123,123,123,0
203447,Kent State University at Ashtabula,2341,1344,670,1671
203456,Kent State University at East Liverpool,1672,813,232,1440
203526,Kent State University at Geauga,2653,1422,589,2064
203517,Kent State University at Kent,28998,24549,21737,7261
203492,Kent State University at Salem,1846,1164,703,1143
203465,Kent State University at Stark,4886,3291,2215,2671
203474,Kent State University at Trumbull,3087,1797,926,2161
203483,Kent State University at Tuscarawas,2408,1492,875,1533
157100,Kentucky Christian University,594,534,496,98
157030,Kentucky Mountain Bible College,79,70,64,15
157058,Kentucky State University,2533,2144,1887,646
157076,Kentucky Wesleyan College,657,635,621,36
203535,Kenyon College,1705,1699,1695,10
203544,Kettering College,880,647,497,383
169983,Kettering University,1985,1756,1612,373
192192,Keuka College,2036,1806,1658,378
461315,Keweenaw Bay Ojibwa Community College,106,78,64,42
134422,Key College,68,68,68,0
213303,Keystone College,1595,1426,1317,278
210483,Keystone Technical Institute,313,313,313,0
375692,Kiamichi Technology Center-Atoka,123,53,17,106
375708,Kiamichi Technology Center-Durant,288,145,73,215
375717,Kiamichi Technology Center-Hugo,101,64,45,56
375735,Kiamichi Technology Center-Idabel,75,52,40,35
375726,Kiamichi Technology Center-McAlester,195,137,107,88
375744,Kiamichi Technology Center-Poteau,246,150,102,144
375753,Kiamichi Technology Center-Spiro,57,36,26,31
405748,Kiamichi Technology Center-Stigler,16,11,9,7
375762,Kiamichi Technology Center-Talihina,101,57,35,66
226019,Kilgore College,5867,3712,2623,3244
219055,Kilian Community College,253,121,34,219
220516,King University,2575,2449,2369,206
213321,King's College,2391,2146,1991,400
382504,King's College,381,381,381,0
439701,King's University,598,362,212,386
417628,Kirksville Area Technical Center,27,26,26,1
153737,Kirkwood Community College,15076,9685,6960,8116
170587,Kirtland Community College,1805,1067,694,1111
146418,Kishwaukee College,4717,3143,2348,2369
213330,Kittanning Beauty School,19,19,19,0
428392,Klamath Community College,1304,799,544,760
260956,Knowledge Systems Institute,186,184,182,4
151564,Knox Beauty College,39,25,16,23
146427,Knox College,1424,1409,1400,24
375373,Knox County Career Center,252,252,252,0
220570,Knoxville Institute of Hair Design,40,30,23,17
441751,Kussad Institute of Court Reporting,18,18,18,0
213349,Kutztown University of Pennsylvania,9513,8919,8548,965
171881,Kuyper College,291,265,248,43
160481,L E Fletcher Technical Community College,1968,1497,1259,709
434380,L T International Beauty School,51,51,51,0
162982,L'Academie de Cuisine,46,46,46,0
481915,L'Ecole Culinaire-Kansas City,73,73,73,0
456940,L'Ecole Culinaire-Memphis,441,441,441,0
445726,L'Ecole Culinaire-St Louis,269,269,269,0
457633,L'esprit Academy,129,110,97,32
166319,La Baron Hairdressing Academy-Brockton,44,33,25,19
166328,La Baron Hairdressing Academy-New Bedford,102,68,46,56
155441,La Baron Hairdressing Academy-Overland Park,37,29,24,13
383163,La Belle Beauty Academy,435,202,49,386
135142,La Belle Beauty School,290,145,49,241
153773,La James College of Hairstyling and Cosmetology,103,103,103,0
153746,La James International College-Cedar Falls,92,92,92,0
154332,La James International College-Davenport,47,47,47,0
143695,La James International College-East Moline,23,23,23,0
153782,La James International College-Ft Dodge,84,84,84,0
154341,La James International College-Iowa City,64,64,64,0
153764,La James International College-Johnston,100,100,100,0
213358,La Roche College,1481,1299,1183,298
213367,La Salle University,6436,4908,3948,2488
117627,La Sierra University,2440,2239,2112,328
180771,La'James International College,33,33,33,0
155450,Labette Community College,1959,1115,689,1270
165264,Laboure College,698,335,100,598
260372,Lac Courte Oreilles Ojibwa Community College,303,231,194,109
213376,Lackawanna College,1454,1209,1048,406
439729,Lacy Cosmetology School-Aiken,17,13,10,7
451811,Lacy Cosmetology School-Goose Creek,38,22,11,27
451802,Lacy Cosmetology School-Lexington,18,18,18,0
476373,Lacy Cosmetology School-West Ashley,9,9,9,0
151607,Lafayette Beauty Academy,82,69,61,21
213385,Lafayette College,2486,2455,2435,51
140234,LaGrange College,940,890,858,82
117168,Laguna College of Art and Design,544,512,491,53
461290,Laird Institute of Spa Therapy,50,29,15,35
219143,Lake Area Technical Institute,1559,1431,1366,193
177870,Lake Career and Technical Center,13,13,13,0
203580,Lake Erie College,1086,956,875,211
407629,Lake Erie College of Osteopathic Medicine,3594,3594,3594,0
146481,Lake Forest College,1618,1596,1582,36
146490,Lake Forest Graduate School of Management,530,202,0,530
146506,Lake Land College,6351,3998,2809,3542
455840,Lake Lanier School of Massage,155,155,155,0
170620,Lake Michigan College,4230,2285,1302,2928
200192,Lake Region State College,1898,960,486,1412
173461,Lake Superior College,5394,3232,2140,3254
170639,Lake Superior State University,2435,2156,1967,468
117195,Lake Tahoe Community College,2426,1323,765,1661
135179,Lake Technical Center,637,498,428,209
235699,Lake Washington Institute of Technology,3819,2685,1918,1901
135188,Lake-Sumter State College,4288,2474,1246,3042
238980,Lakeland College,3806,2185,1148,2658
203599,Lakeland Community College,8839,5074,3171,5668
183123,Lakes Region Community College,1181,723,492,689
239008,Lakeshore Technical College,2930,1588,910,2020
146533,Lakeview College of Nursing,316,278,254,62
451291,Lakewood School of Therapeutic Massage,22,9,0,22
127389,Lamar Community College,902,610,463,439
441760,Lamar Institute of Technology,2995,1913,1366,1629
226107,Lamar State College-Orange,2426,1473,992,1434
226116,Lamar State College-Port Arthur,2721,1548,955,1766
226091,Lamar University,14035,9888,7356,6679
456214,Lamson Institute,169,169,169,0
117238,Lancaster Beauty School,93,93,93,0
213400,Lancaster Bible College,1763,1232,895,868
418533,Lancaster County Career and Technology Center,407,286,225,182
213455,Lancaster School of Cosmetology,195,93,26,169
213446,Lancaster Theological Seminary,128,100,82,46
218229,Lander University,2877,2704,2592,285
247649,Landmark College,494,492,491,3
220598,Lane College,1554,1542,1534,20
209038,Lane Community College,11002,7012,4996,6006
117247,Laney College,11362,5081,1907,9455
207209,Langston University,2533,2219,2025,508
140243,Lanier Technical College,3579,1894,1042,2537
213473,Lansdale School of Business,382,264,186,196
213491,Lansdale School of Cosmetology Inc,68,45,30,38
170657,Lansing Community College,17562,10272,6587,10975
240620,Laramie County Community College,4780,2907,1961,2819
226125,Laredo Beauty College Inc,283,283,283,0
226134,Laredo Community College,8726,5074,3228,5498
476489,Larry's Barber College,16,16,16,0
366401,Las Positas College,8631,4839,2923,5708
166391,Lasell College,2081,1887,1767,314
117274,Lassen Community College,2494,1236,600,1894
230418,Latter-day Saints Business College,2036,1658,1409,627
250027,Laurel Business Institute,212,211,211,1
215992,Laurel Technical Institute,285,272,263,22
198747,Laurel University,610,330,152,458
454786,Laurus College,856,382,70,786
411055,Laurus Technical Institute,477,477,477,0
481298,Lawrence & Company College of Cosmetology,57,57,57,0
364618,Lawrence County Career and Technical Center-Practical Nursing Program,34,34,34,0
166407,Lawrence Memorial Hospital School of Nursing,302,280,266,36
170675,Lawrence Technological University,4002,2516,1571,2431
239017,Lawrence University,1553,1532,1518,35
101569,Lawson State Community College-Birmingham Campus,3028,2204,1788,1240
459514,Lawyer's Assistant School of Dallas,48,48,48,0
443623,Le Cordon Bleu College of Culinary Arts-Atlanta,1108,1108,1108,0
364973,Le Cordon Bleu College of Culinary Arts-Austin,655,655,655,0
452054,Le Cordon Bleu College of Culinary Arts-Cambridge,488,488,488,0
144467,Le Cordon Bleu College of Culinary Arts-Chicago,958,958,958,0
452063,Le Cordon Bleu College of Culinary Arts-Dallas,892,892,892,0
445115,Le Cordon Bleu College of Culinary Arts-Las Vegas,605,605,605,0
446835,Le Cordon Bleu College of Culinary Arts-Miami,721,721,721,0
446844,Le Cordon Bleu College of Culinary Arts-Minneapolis,572,572,572,0
442231,Le Cordon Bleu College of Culinary Arts-Orlando,961,961,961,0
423980,Le Cordon Bleu College of Culinary Arts-Pasadena,1739,1739,1739,0
375841,Le Cordon Bleu College of Culinary Arts-Portland,563,563,563,0
452036,Le Cordon Bleu College of Culinary Arts-Sacramento,375,375,375,0
111009,Le Cordon Bleu College of Culinary Arts-San Francisco,489,489,489,0
262332,Le Cordon Bleu College of Culinary Arts-Scottsdale,1551,1551,1551,0
452045,Le Cordon Bleu College of Culinary Arts-Seattle,439,439,439,0
456302,Le Cordon Bleu College of Culinary Arts-St Louis,302,302,302,0
192323,Le Moyne College,3319,2841,2538,781
220604,Le Moyne-Owen College,1023,936,879,144
182908,Lebanon College,87,52,29,58
418542,Lebanon County Area Vocational Technical School,159,114,91,68
374112,Lebanon Technology and Career Center,26,25,24,2
213507,Lebanon Valley College,2022,1840,1725,297
226204,Lee College,5911,2949,1452,4459
220613,Lee University,4922,4358,3997,925
413626,Leech Lake Tribal College,348,300,275,73
107211,Lees School of Cosmetology,27,27,27,0
198808,Lees-McRae College,890,886,883,7
141811,Leeward Community College,7976,4764,3141,4835
444228,LeGrand Institute of Cosmetology Inc,31,31,31,0
213525,Lehigh Carbon Community College,7128,4083,2544,4584
213543,Lehigh University,7096,6511,6148,948
476744,LeMelange Academy of Hair,48,29,17,31
418515,Lenape Technical School Practical Nursing Program,79,60,51,28
198817,Lenoir Community College,2813,1837,1343,1470
198835,Lenoir-Rhyne University,1898,1666,1519,379
218265,Lenoir-Rhyne University-Lutheran Theological Southern Seminary,107,84,70,37
441618,Leon Studio One School of Hair Design,14,12,10,4
479123,Leon Studio One School of Hair Design & Career Training Center,19,19,19,0
198844,Leons Beauty School Inc,143,109,87,56
166452,Lesley University,5195,3568,2554,2641
433217,Lester E Cox Medical Center-School of Medical Technology,7,7,7,0
444732,Leston College,180,180,180,0
226231,LeTourneau University,2729,1913,1392,1337
213552,Levittown Beauty Academy,84,63,49,35
209056,Lewis & Clark College,3521,3267,3110,411
146603,Lewis and Clark Community College,8520,4469,2421,6099
146612,Lewis University,6525,5050,4123,2402
142328,Lewis-Clark State College,4304,3194,2443,1861
177931,Lex La-Ray Technical Center,35,35,35,0
146621,Lexington College,55,49,45,10
450632,Lexington Healing Arts Academy,154,61,0,154
157207,Lexington Theological Seminary,84,44,19,65
427335,Lia Schorr Institute of Cosmetic Skin Care Training,60,41,28,32
455956,Liberty Technical College,109,109,109,0
232557,Liberty University,77338,52244,36353,40985
242820,Liceo de Arte y Tecnologia,1316,1316,1316,0
376330,Liceo de Arte-Dise-O y Comercio,325,321,319,6
117520,Life Chiropractic College West,456,441,431,25
117104,Life Pacific College,627,518,447,180
140252,Life University,2730,2492,2342,388
475574,Lil Lou's Barber College,62,53,47,15
192271,LIM College,1647,1572,1524,123
218238,Limestone College,3307,2750,2390,917
146667,Lincoln Christian University,997,836,734,263
146676,Lincoln College,1240,972,798,442
128683,Lincoln College of New England-Southington,837,629,494,343
462266,Lincoln College of Technology-Cleveland,79,79,79,0
163028,Lincoln College of Technology-Columbia,693,597,533,160
205726,Lincoln College of Technology-Dayton,58,58,58,0
126951,Lincoln College of Technology-Denver,1262,1262,1262,0
245032,Lincoln College of Technology-Florence,97,97,97,0
226277,Lincoln College of Technology-Grand Prairie,867,867,867,0
151661,Lincoln College of Technology-Indianapolis,1240,1240,1240,0
434159,Lincoln College of Technology-Marietta,267,267,267,0
146700,Lincoln College of Technology-Melrose Park,617,617,617,0
221148,Lincoln College of Technology-Nashville,1856,1856,1856,0
456278,Lincoln College of Technology-Toledo,60,60,60,0
205708,Lincoln College of Technology-Tri-County,123,123,123,0
136066,Lincoln College of Technology-West Palm Beach,738,703,681,57
146685,Lincoln Land Community College,7020,4340,2985,4035
220631,Lincoln Memorial University,3952,3359,2983,969
213570,Lincoln Technical Institute-Allentown,568,568,568,0
425889,Lincoln Technical Institute-Brockton,378,333,303,75
442046,Lincoln Technical Institute-Center City Philadelphia,478,454,438,40
129181,Lincoln Technical Institute-East Windsor,655,535,456,199
184056,Lincoln Technical Institute-Edison,607,494,419,188
439437,Lincoln Technical Institute-Fern Park,231,231,231,0
439039,Lincoln Technical Institute-Hamden,205,162,134,71
410788,Lincoln Technical Institute-Hartford,575,401,287,288
433101,Lincoln Technical Institute-Lincoln,607,524,470,137
440952,Lincoln Technical Institute-Lowell,388,332,295,93
420343,Lincoln Technical Institute-Mahwah,665,537,453,212
374574,Lincoln Technical Institute-Moorestown,579,448,361,218
129923,Lincoln Technical Institute-New Britain,465,353,279,186
442037,Lincoln Technical Institute-Northeast Philadelphia,311,311,311,0
442073,Lincoln Technical Institute-Paramus,645,480,371,274
213589,Lincoln Technical Institute-Philadelphia,273,240,219,54
445911,Lincoln Technical Institute-Shelton,532,421,348,184
165556,Lincoln Technical Institute-Somerville,331,259,212,119
184427,Lincoln Technical Institute-South Plainfield,255,255,255,0
185396,Lincoln Technical Institute-Union,1171,1052,973,198
449320,Lincoln Technical Institute-Whitestone,748,748,748,0
403478,Lincoln Trail College,972,606,421,551
177940,Lincoln University,3043,2366,1916,1127
117557,Lincoln University,492,458,436,56
213598,Lincoln University of Pennsylvania,1963,1808,1712,251
177968,Lindenwood University,12213,10385,9238,2975
135294,Lindsey Hopkins Technical Education Center,890,680,574,316
461722,Lindsey Institute of Cosmetology,71,68,66,5
157216,Lindsey Wilson College,2644,2568,2520,124
437325,Linfield College-Adult Degree Program,515,242,66,449
209065,Linfield College-McMinnville Campus,1671,1646,1630,41
437316,Linfield College-School of Nursing,344,337,332,12
177977,Linn State Technical College,1294,1170,1108,186
209074,Linn-Benton Community College,5617,3616,2604,3013
219976,Lipscomb University,4580,3856,3403,1177
180328,Little Big Horn College,329,289,269,60
434016,Little Priest Tribal College,144,101,73,71
192563,LIU Brentwood,270,184,130,140
192439,LIU Brooklyn,8483,7119,6261,2222
192554,LIU Hudson at Rockland,259,157,94,165
432357,LIU Hudson at Westchester,205,117,63,142
192448,LIU Post,10599,7077,4824,5775
450766,LIU Riverhead,215,118,57,158
135276,Lively Technical Center,1017,806,700,317
421832,Living Arts College,513,513,513,0
198862,Livingstone College,1175,1168,1164,11
213613,Lock Haven University,5260,4931,4723,537
177986,Logan University,969,883,829,140
117636,Loma Linda University,4693,4089,3711,982
227182,Lone Star College System,64072,34674,19815,44257
117645,Long Beach City College,24020,14395,9530,14490
476610,Long Island Barber Institute,75,75,75,0
383297,Long Island Beauty School-Hauppauge,311,259,224,87
192484,Long Island Beauty School-Hempstead,147,119,100,47
192509,Long Island Business Institute,446,365,311,135
461838,Long Island Nail & Skin Care Institute,139,86,51,88
479983,Longs Peak Academy,49,41,35,14
232566,Longwood University,4960,4532,4265,695
166489,Longy School of Music of Bard College,265,255,249,16
203748,Lorain County Community College,12274,6373,3391,8883
409591,Lorain County Joint Vocational School District,106,81,68,38
135337,Loraines Academy Inc,209,174,151,58
153825,Loras College,1621,1547,1500,121
232575,Lord Fairfax Community College,7238,3734,1963,5275
133155,Lorenzo Walker Institute of Technology,614,410,307,307
117788,Los Angeles City College,19635,9556,4462,15173
117803,Los Angeles County College of Nursing and Allied Health,185,62,0,185
436429,Los Angeles Film School,2218,2218,2218,0
117690,Los Angeles Harbor College,10098,5074,2535,7563
117867,Los Angeles Mission College,8990,4308,1941,7049
446385,Los Angeles Music Academy,148,144,142,6
368780,Los Angeles ORT College-Los Angeles Campus,396,396,396,0
381945,Los Angeles ORT College-Van Nuys Campus,43,43,43,0
117706,Los Angeles Pierce College,20080,9723,4489,15591
117715,Los Angeles Southwest College,7864,3526,1333,6531
117724,Los Angeles Trade Technical College,13879,6949,3447,10432
117733,Los Angeles Valley College,18762,9306,4526,14236
117894,Los Medanos College,8525,4662,2709,5816
198871,Louisburg College,678,676,674,4
159531,Louisiana Academy of Beauty,42,42,42,0
159568,Louisiana College,1400,1211,1092,308
449612,Louisiana Culinary Institute,195,195,195,0
483212,Louisiana Delta Community College,3949,2569,1871,2078
159391,Louisiana State University and Agricultural & Mechanical College,30478,28456,27172,3306
159373,Louisiana State University Health Sciences Center-New Orleans,2829,2542,2359,470
435000,Louisiana State University Health Sciences Center-Shreveport,856,831,816,40
159382,Louisiana State University-Alexandria,2229,1648,1257,972
159407,Louisiana State University-Eunice,2673,1750,1283,1390
159416,Louisiana State University-Shreveport,4114,2977,2229,1885
159647,Louisiana Tech University,11015,8914,7549,3466
157298,Louisville Presbyterian Theological Seminary,199,147,115,84
203757,Lourdes University,2187,1740,1452,735
458007,Love Beauty School Inc,53,49,46,7
166498,Lowell Academy Hairstyling Institute,102,85,74,28
235750,Lower Columbia College,3152,2143,1633,1519
117946,Loyola Marymount University,9661,9076,8710,951
146719,Loyola University Chicago,15957,14425,13463,2494
163046,Loyola University Maryland,5977,5117,4585,1392
159656,Loyola University New Orleans,4686,4010,3589,1097
117955,Lu Ross Academy,186,186,186,0
226383,Lubbock Christian University,2002,1591,1332,670
226374,Lubbock Hair Academy,49,49,49,0
234924,Lucas Marc Academy,128,128,128,0
363633,Luna Community College,1657,906,527,1130
101602,Lurleen B Wallace Community College,1570,1173,972,598
153834,Luther College,2466,2434,2413,53
135364,Luther Rice University & Seminary,1277,668,285,992
173896,Luther Seminary,705,517,401,304
178004,Lutheran School of Nursing,209,156,121,88
146728,Lutheran School of Theology at Chicago,261,202,165,96
213631,Lutheran Theological Seminary at Gettysburg,122,99,85,37
213640,Lutheran Theological Seminary at Philadelphia,230,138,81,149
213659,Luzerne County Community College,6411,4259,3172,3239
213668,Lycoming College,1307,1297,1290,17
118134,Lyles Bakersfield College of Beauty,67,54,45,22
118143,Lyles Fresno College of Beauty,56,43,35,21
129686,Lyme Academy College of Fine Arts,77,72,69,8
232609,Lynchburg College,2713,2480,2335,378
232618,Lynchburg General Hospital School of Nursing,144,78,34,110
230931,Lyndon State College,1519,1360,1259,260
132657,Lynn University,2297,2081,1945,352
444750,Lynndale Fundamentals of Beauty School,6,6,6,0
482246,Lynnes Welding Training,25,25,25,0
106342,Lyon College,592,574,562,30
118161,Lytles Redwood Empire Beauty College Inc,126,126,126,0
170736,M J Murphy Beauty College of Mount Pleasant,82,82,82,0
481003,M T Training Center,62,62,62,0
441414,M-DCPS The English Center,390,183,78,312
146807,Mac Daniels Beauty School,62,48,39,23
173902,Macalester College,2039,2022,2011,28
146816,MacCormac College,215,148,104,111
192624,Machzikei Hadath Rabbinical College,148,148,148,0
146825,MacMurray College,571,538,517,54
170790,Macomb Community College,23446,12859,7508,15938
367662,Madera Beauty College,55,26,7,48
375407,Madison Adult Career Center,145,124,114,31
238263,Madison Area Technical College,15402,9291,5160,10242
364168,Madison Media Institute,396,389,385,11
148399,Madison Media Institute - Rockford Career College,484,321,214,270
379621,Madison Oneida BOCES-Practical Nursing Program,51,51,51,0
157304,Madisonville Community College,4522,2485,1455,3067
170806,Madonna University,4399,2795,1774,2625
176390,Magnolia College of Cosmetology,133,133,133,0
210784,Magnolia School,106,89,78,28
153861,Maharishi University of Management,1136,948,832,304
407489,Mahoning County Career and Technical Center,96,69,55,41
448202,Mai-trix Beauty College,53,41,33,20
161509,Maine College of Art,409,399,392,17
161299,Maine Maritime Academy,1018,1008,1001,17
449366,Make-up Designory,241,220,206,35
203775,Malone University,2074,1737,1525,549
451103,Management Resources Institute,822,822,822,0
135407,Manatee Technical Institute,1252,1250,1249,3
118116,Manchester Beauty College,67,31,7,60
183132,Manchester Community College,2898,1563,889,2009
129695,Manchester Community College,7571,4343,2712,4859
151777,Manchester University,1349,1336,1327,22
461272,Mandalyn Academy,65,48,36,29
192688,Mandl School-The College of Allied Health,782,779,777,5
155487,Manhattan Area Technical College,825,603,491,334
155496,Manhattan Christian College,327,263,222,105
192703,Manhattan College,3883,3582,3392,491
135416,Manhattan Hairstyling Academy,254,254,254,0
461351,Manhattan Institute,1135,483,53,1082
420981,Manhattan School of Computer Technology,448,448,448,0
192712,Manhattan School of Music,885,883,882,3
192749,Manhattanville College,2750,2226,1900,850
213774,Manor College,858,622,467,391
166595,Mansfield Beauty Schools-Quincy,60,47,39,21
166586,Mansfield Beauty Schools-Springfield,38,33,30,8
213783,Mansfield University of Pennsylvania,2970,2666,2477,493
480754,Manthano Christian College,28,22,18,10
451547,Manuel and Theresa's School of Hair Design-Bryan,25,25,25,0
470296,Manuel and Theresa's School of Hair Design-Victoria,23,23,23,0
446394,Maple Springs Baptist Bible College and Seminary,105,45,7,98
239071,Maranatha Baptist University,1035,841,717,318
459329,Marchman Technical Education Center,161,158,157,4
107363,Margaret's Hair Academy Inc,65,65,65,0
192785,Maria College of Albany,880,461,190,690
166601,Marian Court College,266,183,130,136
411684,Marian Health Careers Center-Los Angeles Campus,108,108,108,0
475282,Marian Health Careers Center-Van Nuys Campus,94,94,94,0
239080,Marian University,2188,1695,1384,804
151786,Marian University,2714,2194,1863,851
246895,Maricopa Skill Center,798,526,389,409
203845,Marietta College,1542,1473,1429,113
114071,Marinello Schools of Beauty-Burbank,397,337,297,100
128957,Marinello Schools of Beauty-East Hartford,151,129,115,36
113397,Marinello Schools of Beauty-Hemet,1330,1159,1047,283
124344,Marinello Schools of Beauty-Lake Forest,567,548,536,31
182209,Marinello Schools of Beauty-Las Vegas,398,268,183,215
118356,Marinello Schools of Beauty-Los Angeles,2405,2084,1872,533
154970,Marinello Schools of Beauty-Manhattan,111,107,105,6
130129,Marinello Schools of Beauty-Meriden,503,442,402,101
114080,Marinello Schools of Beauty-Moreno Valley,254,237,225,29
445993,Marinello Schools of Beauty-Niantic,307,255,221,86
380401,Marinello Schools of Beauty-Provo,79,63,52,27
182397,Marinello Schools of Beauty-Reno,275,186,127,148
417132,Marinello Schools of Beauty-Sacramento,561,503,464,97
118921,Marinello Schools of Beauty-San Francisco,616,520,456,160
113908,Marinello Schools of Beauty-Santa Clara,566,433,345,221
439589,Marinello Schools of Beauty-Topeka,302,250,215,87
419262,Marion Community Schools-Tucker Career & Technology Center,6,6,6,0
419226,Marion County Community Technical and Adult Education Center,427,427,427,0
101648,Marion Military Institute,418,413,411,7
192800,Marion S Whelan School of Nursing of Geneva General Hospital,32,32,32,0
203881,Marion Technical College,2698,1505,902,1796
192819,Marist College,6365,5603,5121,1244
468866,MarJon School of Beauty ltd-Lockport,65,65,65,0
192828,MarJon School of Beauty ltd-Tonawanda,44,37,33,11
457642,Marketti Academy of Cosmetology,59,49,42,17
230940,Marlboro College,260,241,228,32
440411,Marlboro College-Graduate School,114,60,26,88
239105,Marquette University,11782,10786,10164,1618
198899,Mars Hill University,1440,1375,1333,107
107275,Marsha Kay Beauty College,15,15,15,0
123943,Marshall B Ketchum University,397,397,397,0
237525,Marshall University,13407,11262,9949,3458
153922,Marshalltown Community College,2101,1328,937,1164
198905,Martin Community College,799,522,382,417
173452,Martin Luther College,824,754,710,114
220701,Martin Methodist College,1144,1066,1016,128
151810,Martin University,506,329,215,291
232672,Mary Baldwin College,1711,1368,1149,562
170842,Marygrove College,1960,1256,816,1144
163815,Maryland Beauty Academy of Essex,101,62,37,64
163107,Maryland Beauty Academy of Reisterstown,30,19,11,19
163295,Maryland Institute College of Art,2273,2118,2020,253
164085,Maryland University of Integrative Health,591,502,447,144
209108,Marylhurst University,1408,702,255,1153
118541,Marymount California University,1037,1018,1006,31
192864,Marymount Manhattan College,1833,1687,1593,240
232706,Marymount University,3486,2992,2682,804
220710,Maryville College,1168,1146,1132,36
178059,Maryville University of Saint Louis,5033,3156,1977,3056
213826,Marywood University,3175,2809,2580,595
166647,Massachusetts Bay Community College,5377,3108,1961,3416
166674,Massachusetts College of Art and Design,2264,1982,1793,471
167288,Massachusetts College of Liberal Arts,1716,1505,1374,342
431594,Massachusetts General Hospital Dietetic Internship,20,20,20,0
166683,Massachusetts Institute of Technology,11301,11201,11138,163
166692,Massachusetts Maritime Academy,1476,1387,1333,143
166805,Massachusetts School of Barbering,91,52,26,65
369002,Massachusetts School of Law,529,368,269,260
166717,Massachusetts School of Professional Psychology,652,544,478,174
381361,Massage Therapy Institute of Colorado,82,82,82,0
448035,Massage Therapy Trainining Institute,25,22,20,5
166823,Massasoit Community College,8272,5181,3618,4654
457509,Master Educators Beauty School,33,33,33,0
151829,Masters of Cosmetology College,96,96,96,0
461333,Mauna Loa Helicopters,19,8,0,19
448220,Maximum Style Tec School of Cosmetology,42,42,42,0
454698,Mayfield College,329,329,329,0
198914,Mayland Community College,1254,680,390,864
365426,Mayo Graduate School,322,263,227,95
173957,Mayo Medical School,195,195,195,0
173966,Mayo School of Health Sciences,335,335,335,0
157331,Maysville Community and Technical College,3595,2296,1640,1955
200226,Mayville State University,1065,779,587,478
242884,MBTI Business Training Institute,4431,4427,4425,6
438212,McCann School of Business & Technology,3544,2777,2272,1272
146977,McCormick Theological Seminary,207,111,51,156
164270,McDaniel College,3229,2357,1817,1412
198923,McDowell Technical Community College,1152,679,440,712
147004,McHenry County College,7023,4113,2642,4381
446400,MCI Institute of Technology,148,148,148,0
147013,McKendree University,3027,2358,1935,1092
226578,McLennan Community College,8555,5427,3846,4709
226587,McMurry University,1216,1105,1034,182
367194,McNally Smith College of Music,596,473,393,203
159717,McNeese State University,8341,7110,6307,2034
155511,McPherson College,656,624,603,53
166656,MCPHS University,6548,6237,6042,506
147031,Meadville Lombard Theological School,84,59,44,40
414461,Mech-Tech College,3262,2971,2780,482
141848,Med-Assist School of Hawaii Inc,81,79,78,3
192925,Medaille College,2390,2265,2185,205
456144,MediaTech Institute-Austin,87,87,87,0
455336,MediaTech Institute-Dallas,176,176,176,0
456153,MediaTech Institute-Houston,126,126,126,0
475501,MediaTech Institute-Oceanside,51,51,51,0
476595,Medical Allied Career Center,65,41,25,40
479965,Medical Career Institute,77,77,77,0
239169,Medical College of Wisconsin,1212,1087,1010,202
455831,Medical Institute of Palm Beach,122,122,122,0
444769,Medical Professional Institute,283,191,130,153
436650,Medical Training College,98,98,98,0
218335,Medical University of South Carolina,2775,2659,2593,182
203942,Medina County Career Center,105,76,62,43
476993,Medspa Academies,130,123,118,12
448415,MedTech College,603,603,603,0
456366,MedTech College-Ft Wayne Campus,357,357,357,0
456357,MedTech College-Greenwood Campus,551,551,551,0
456375,MedTech College-Lexington Campus,180,180,180,0
131742,Medtech Institute,1373,1373,1373,0
444714,MedTech Institute-Atlanta Campus,539,539,539,0
481632,MedTech Institute-Orlando Campus,376,376,376,0
442745,Medvance Institute-West Palm,365,365,365,0
220792,Meharry Medical College,801,801,801,0
192970,Memorial Hospital School of Radiation Therapy Technology,15,15,15,0
192961,Memorial School of Nursing,123,56,12,111
220808,Memphis College of Art,428,382,353,75
451538,Memphis Institute of Barbering,120,120,120,0
220871,Memphis Theological Seminary,292,223,181,111
118684,Mendocino College,3729,2086,1256,2473
118693,Menlo College,745,725,712,33
118718,Merced College,10205,6669,4882,5323
366632,Mercer County Career Center,40,40,40,0
185509,Mercer County Community College,8501,4909,3093,5408
237543,Mercer County Technical Education Center,219,120,70,149
140447,Mercer University,8351,7175,6435,1916
193016,Mercy College,11648,8814,7017,4631
153977,Mercy College of Health Sciences,831,543,357,474
203960,Mercy College of Ohio,1195,774,501,694
431600,Mercy Hospital School of Nursing,168,165,163,5
419217,Mercy Hospital School of Practical Nursing-Plantation General Hospital,138,138,138,0
179399,Mercy Hospital Springfield-School of Radiologic Technology,15,15,15,0
198941,Mercy School of Nursing,137,53,11,126
366571,Mercy-St Luke's School of Radiologic Technology,24,24,24,0
213987,Mercyhurst University,3011,2824,2706,305
480189,Mercyhurst University-North East Campus,1032,849,728,304
198950,Meredith College,1872,1706,1602,270
237552,Meredith Manor International Equestrian Center,121,121,121,0
244279,Meridian College,163,163,163,0
175935,Meridian Community College,3713,2895,2481,1232
461324,Meridian Institute of Surgical Assisting,249,249,249,0
365480,Meridian Technology Center,807,374,155,652
427308,Merkaz Bnos-Business School,150,150,150,0
178077,Merrell University of Beauty Arts and Science,107,107,107,0
151874,Merrillville Beauty College,62,57,53,9
166850,Merrimack College,3067,2897,2790,277
118772,Merritt College,5887,2533,838,5049
105154,Mesa Community College,23678,12965,7550,16128
173993,Mesabi Range Community and Technical College,1425,1037,841,584
188261,Mesalands Community College,697,387,231,466
461847,Mesivta Keser Torah,33,33,33,0
193061,Mesivta of Eastern Parkway-Yeshiva Zichron Meilech,36,36,36,0
193052,Mesivta Torah Vodaath Rabbinical Seminary,279,277,276,3
193070,Mesivtha Tifereth Jerusalem of America,80,80,80,0
417752,Messenger College,47,42,38,9
213996,Messiah College,3084,2885,2760,324
147129,Methodist College,508,412,350,158
203997,Methodist Theological School in Ohio,193,156,133,60
198969,Methodist University,2463,2242,2100,363
457952,Metro Beauty Academy,206,176,157,49
455673,Metro Business College-Arnold,50,45,42,8
178110,Metro Business College-Cape Girardeau,137,129,124,13
245430,Metro Business College-Jefferson City,142,125,113,29
245421,Metro Business College-Rolla,71,67,65,6
363165,Metro Technology Centers,914,641,503,411
226772,Metroplex Beauty School,58,42,32,26
214023,Metropolitan Career Center Computer Technology Institute,96,72,57,39
190114,Metropolitan College of New York,1255,1199,1164,91
181303,Metropolitan Community College Area,15752,9258,5976,9776
177995,Metropolitan Community College-Kansas City,19234,11595,7734,11500
441575,Metropolitan Learning Institute,864,864,864,0
174020,Metropolitan State University,8510,5215,3033,5477
127565,Metropolitan State University of Denver,22752,17232,13508,9244
166869,MGH Institute of Health Professions,1096,903,784,312
428000,Miami Ad School-Miami Beach,173,173,173,0
440800,Miami Ad School-Minneapolis,18,18,18,0
476355,Miami Ad School-New York,97,97,97,0
440819,Miami Ad School-San Francisco,131,131,131,0
135717,Miami Dade College,66298,42607,26579,39719
135647,Miami Lakes Educational Center,1158,885,747,411
204006,Miami University-Hamilton,3621,2965,2521,1100
204015,Miami University-Middletown,2221,1690,1330,891
204024,Miami University-Oxford,17901,16731,16038,1863
204158,Miami Valley Career Technology Center,407,407,407,0
369862,Miami-Jacobs Career College-Columbus,304,231,183,121
204060,Miami-Jacobs Career College-Dayton,258,200,161,97
200633,Miami-Jacobs Career College-Independence,243,183,144,99
441201,Miami-Jacobs Career College-Sharonville,156,119,94,62
449126,Miami-Jacobs Career College-Springboro,222,178,149,73
450003,Miami-Jacobs Career College-Troy,277,232,202,75
169655,MIAT College of Technology,498,469,450,48
182953,Michaels School of Hair Design and Esthetics-Paul Mitchell Partner School,164,137,119,45
171012,Michigan Barber School Inc,163,163,163,0
172422,Michigan Career and Technical Institute,200,200,200,0
170611,Michigan College of Beauty-Monroe,117,100,88,29
381370,Michigan College of Beauty-Troy,301,247,212,89
434414,Michigan Jewish Institute,1662,1419,1262,400
169220,Michigan School of Professional Psychology,161,115,86,75
171100,Michigan State University,49317,45593,43276,6041
169628,Michigan State University-College of Law,998,890,823,175
171128,Michigan Technological University,6975,6471,6158,817
451440,Micropower Career Institute,359,359,359,0
135735,Mid Florida Tech,2025,1536,1289,736
171155,Mid Michigan Community College,4552,2639,1672,2880
245953,Mid-America Christian University,2942,2510,2235,707
151962,Mid-America College of Funeral Service,63,63,63,0
418320,Mid-America Technology Center,762,300,66,696
199458,Mid-Atlantic Christian University,162,142,129,33
157359,Mid-Continent University,2251,2041,1905,346
431017,Mid-Del Technology Center,114,93,82,32
389860,Mid-EastCTC-Adult Education,385,309,270,115
181312,Mid-Plains Community College,2491,1474,960,1531
481225,Mid-South Christian College,29,22,18,11
107318,Mid-South Community College,1793,1069,703,1090
239220,Mid-State Technical College,2905,1654,1021,1884
155520,MidAmerica Nazarene University,1907,1653,1491,416
482158,Middle Georgia State College,7989,6182,4960,3029
220996,Middle Tennessee School of Anesthesia Inc,142,142,142,0
220978,Middle Tennessee State University,23881,20464,18280,5601
230959,Middlebury College,2495,2484,2477,18
129756,Middlesex Community College,2900,1697,1089,1811
166887,Middlesex Community College,9702,5661,3619,6083
185536,Middlesex County College,12602,8655,6660,5942
226806,Midland College,5233,3028,1537,3696
181330,Midland University,1288,1233,1199,89
218353,Midlands Technical College,11634,7392,5248,6386
147165,Midstate College,543,324,183,360
157377,Midway College,1351,982,745,606
193186,Midway Paris Beauty School,103,68,45,58
439020,Midwest College of Oriental Medicine-Chicago,107,87,74,33
383020,Midwest College of Oriental Medicine-Racine,74,58,48,26
178183,Midwest Institute,179,179,179,0
458265,Midwest Technical Institute-East Peoria,849,696,596,253
469638,Midwest Technical Institute-Moline,313,313,313,0
475459,Midwest Technical Institute-Ridgeland,428,428,428,0
437556,Midwest Technical Institute-Springfield,464,464,464,0
482097,Midwest Technical Institute-Springfield,228,228,228,0
178208,Midwestern Baptist Theological Seminary,1132,908,768,364
457536,Midwestern Career College,45,45,45,0
226833,Midwestern State University,5870,4722,3984,1886
143853,Midwestern University-Downers Grove,2730,2692,2668,62
423643,Midwestern University-Glendale,2984,2963,2950,34
480985,Midwives College of Utah,157,157,157,0
418481,Mifflin-Juniata Career and Technology Center,53,53,53,0
385549,Milan Institute of Cosmetology-Amarillo,174,174,174,0
460534,Milan Institute of Cosmetology-El Paso,458,458,458,0
454546,Milan Institute of Cosmetology-Fairfield,98,98,98,0
460516,Milan Institute of Cosmetology-La Quinta,162,162,162,0
482033,Milan Institute of Cosmetology-Nampa,112,112,112,0
454555,Milan Institute of Cosmetology-Reno,224,224,224,0
449904,Milan Institute of Cosmetology-San Antonio Military,248,248,248,0
445665,Milan Institute of Cosmetology-San Antonio Walzem,233,233,233,0
454573,Milan Institute of Cosmetology-Visalia,276,276,276,0
440855,Milan Institute-Amarillo,162,162,162,0
457077,Milan Institute-Bakersfield,411,411,411,0
448895,Milan Institute-Clovis,488,488,488,0
475325,Milan Institute-Las Vegas,402,402,402,0
482060,Milan Institute-Merced,148,148,148,0
460525,Milan Institute-Nampa,255,255,255,0
442657,Milan Institute-Palm Desert,272,272,272,0
437778,Milan Institute-San Antonio Ingram,314,314,314,0
443669,Milan Institute-Sparks,328,328,328,0
112288,Milan Institute-Visalia,354,354,354,0
193201,Mildred Elley School-Albany Campus,904,901,899,5
461014,Mildred Elley-New York Campus,617,614,612,5
425986,Mildred Elley-Pittsfield Campus,196,196,196,0
101675,Miles College,1666,1612,1577,89
180373,Miles Community College,422,307,249,173
461883,Millennia Atlantic University,112,80,60,52
451264,Millennium Training Institute,177,177,177,0
449117,Miller-Motte College-Cary,320,260,221,99
458405,Miller-Motte College-Fayetteville,734,637,573,161
455655,Miller-Motte College-Greenville,446,339,269,177
460817,Miller-Motte College-Jacksonville,475,379,316,159
456205,Miller-Motte College-Raleigh,459,354,285,174
198978,Miller-Motte College-Wilmington,2856,2070,1562,1294
460826,Miller-Motte Technical College-Augusta,485,363,283,202
443650,Miller-Motte Technical College-Chattanooga,442,341,275,167
382771,Miller-Motte Technical College-Clarksville,524,429,366,158
458441,Miller-Motte Technical College-Columbus,504,406,342,162
460835,Miller-Motte Technical College-Conway,752,597,495,257
475079,Miller-Motte Technical College-Gulfport,237,180,143,94
233091,Miller-Motte Technical College-Lynchburg,472,371,305,167
475060,Miller-Motte Technical College-Macon,350,250,184,166
448664,Miller-Motte Technical College-Madison,425,342,288,137
441025,Miller-Motte Technical College-North Charleston,704,556,458,246
475194,Miller-Motte Technical College-Roanoke,297,236,196,101
214041,Millersville University of Pennsylvania,8279,7389,6832,1447
221014,Milligan College,1198,1130,1086,112
147244,Millikin University,2261,2179,2126,135
118888,Mills College,1595,1490,1424,171
175980,Millsaps College,804,781,767,37
239248,Milwaukee Area Technical College,17961,9837,5731,12230
449861,Milwaukee Career College,88,88,88,0
239309,Milwaukee Institute of Art & Design,667,658,652,15
239318,Milwaukee School of Engineering,2658,2464,2341,317
226860,Mims Classic Beauty College,53,53,53,0
178217,Mineral Area College,4508,3419,2869,1639
368647,Mineral County Vocational Technical Center,25,25,25,0
174118,Minneapolis Business College,235,235,235,0
174127,Minneapolis College of Art and Design,791,734,698,93
174136,Minneapolis Community and Technical College,9691,5518,3409,6282
474881,Minneapolis Media Institute,147,120,103,44
451769,Minnesota School of Business-Blaine,395,312,258,137
407285,Minnesota School of Business-Brooklyn Center,169,127,100,69
456782,Minnesota School of Business-Elk River,291,233,196,95
458742,Minnesota School of Business-Lakeville,203,170,148,55
455585,Minnesota School of Business-Moorhead,182,149,127,55
442578,Minnesota School of Business-Plymouth,190,140,107,83
174279,Minnesota School of Business-Richfield,1037,786,625,412
447670,Minnesota School of Business-Rochester,264,231,209,55
445939,Minnesota School of Business-Shakopee,117,92,76,41
445920,Minnesota School of Business-Waite Park,354,289,247,107
480170,Minnesota School of Cosmetology-Plymouth Campus,86,86,86,0
174190,Minnesota School of Cosmetology-Woodbury Campus,138,138,138,0
175263,Minnesota State College-Southeast Technical,2207,1495,1135,1072
173559,Minnesota State Community and Technical College,6464,4252,3134,3330
173920,Minnesota State University-Mankato,15426,13387,12097,3329
174358,Minnesota State University-Moorhead,6634,5801,5260,1374
173638,Minnesota West Community and Technical College,3231,1958,1315,1916
200253,Minot State University,3533,2775,2273,1260
118912,MiraCosta College,14537,9157,6438,8099
193247,Mirrer Yeshiva Cent Institute,224,224,224,0
214069,Misericordia University,3026,2434,2057,969
118930,Mission College,9130,4671,2417,6713
176053,Mississippi College,4921,4220,3781,1140
176062,Mississippi College of Beauty Culture,82,82,82,0
176008,Mississippi Delta Community College,2950,2522,2305,645
176071,Mississippi Gulf Coast Community College,10106,8004,6941,3165
455105,Mississippi Institute of Aesthetics Nails & Cosmetology,58,58,58,0
176080,Mississippi State University,20161,18169,16951,3210
176035,Mississippi University for Women,2629,2277,2046,583
176044,Mississippi Valley State University,2203,1903,1711,492
178244,Missouri Baptist University,5345,3134,1723,3622
178305,Missouri College,553,540,531,22
440226,Missouri College of Cosmetology North,88,88,88,0
178314,Missouri School of Barbering & Hairstyling,20,20,20,0
178341,Missouri Southern State University,5616,4726,4126,1490
179566,Missouri State University-Springfield,21271,17705,15407,5864
179344,Missouri State University-West Plains,2123,1547,1256,867
178350,Missouri Tech,108,55,21,87
178411,Missouri University of Science and Technology,8129,7221,6663,1466
178369,Missouri Valley College,1668,1488,1371,297
178387,Missouri Western State University,5795,4717,3997,1798
129774,Mitchell College,866,794,747,119
198987,Mitchell Community College,3514,2197,1532,1982
219189,Mitchell Technical Institute,1203,1014,918,285
413972,Mitchell's Hair Styling Academy-Raleigh,76,65,58,18
374440,Mitchells Hairstyling Academy-Goldsboro,46,46,46,0
198996,Mitchells Hairstyling Academy-Greenville,42,42,42,0
199005,Mitchells Hairstyling Academy-Wilson,39,39,39,0
476902,Mitsu Sato Hair Academy,36,31,27,9
441779,MJ's Beauty Academy Inc,68,68,68,0
178448,Moberly Area Community College,5710,3759,2773,2937
174321,Model College of Hair Design,125,125,125,0
118958,Modern Beauty Academy,48,48,48,0
180391,Modern Beauty School Inc,45,45,45,0
242954,Modern Hairstyling Institute-Arecibo,76,69,65,11
242945,Modern Hairstyling Institute-Bayamon,253,220,199,54
438337,Modern Hairstyling Institute-Carolina,188,167,153,35
371928,Modern Technology School,83,83,83,0
193265,Modern Welding School,103,85,73,30
118976,Modesto Junior College,17084,9881,6241,10843
105206,Mohave Community College,5227,2707,1433,3794
193283,Mohawk Valley Community College,7433,5562,4616,2817
118994,Moler Barber College,76,76,76,0
200262,Moler Barber College,7,7,7,0
204121,Moler Hollywood Beauty Academy,80,56,41,39
250902,Moler-Pickens Beauty Academy,74,52,38,36
193292,Molloy College,4455,3503,2903,1552
147341,Monmouth College,1255,1248,1244,11
374592,Monmouth County Vocational School District,98,98,98,0
185572,Monmouth University,6316,5485,4966,1350
237561,Monongalia County Technical Education Center,84,82,81,3
451459,Monroe 2 Orleans BOCES-Center for Workforce Development,108,108,108,0
193308,Monroe College,7215,5932,5106,2109
193326,Monroe Community College,16458,12341,10260,6198
171225,Monroe County Community College,3777,2140,1313,2464
180461,Montana State University,14852,12834,11549,3303
180179,Montana State University-Billings,4969,4004,3372,1597
180522,Montana State University-Northern,1334,1082,918,416
180416,Montana Tech of the University of Montana,2010,1836,1726,284
171234,Montcalm Community College,1944,1087,654,1290
185590,Montclair State University,19464,16511,14702,4762
437705,Monteclaro Escuela de Hoteleria y Artes Culinarias,11,10,9,2
119058,Monterey Institute of International Studies,731,682,651,80
119067,Monterey Peninsula College,9519,4737,2320,7199
451033,Montessori Casa International,22,9,0,22
127954,Montessori Education Center of the Rockies,79,79,79,0
436021,Montessori Institute of Milwaukee,23,23,23,0
163408,Montgomery Beauty School,134,103,83,51
163426,Montgomery College,26155,14919,9240,16915
199023,Montgomery Community College,884,499,304,580
214111,Montgomery County Community College,13122,7439,4567,8555
199032,Montreat College,926,749,635,291
166911,Montserrat College of Art,392,384,379,13
433040,Monty Tech,40,40,40,0
147369,Moody Bible Institute,3709,3032,2601,1108
444662,Moore Career College,59,51,45,14
214148,Moore College of Art and Design,484,457,440,44
248606,Moore Norman Technology Center,1165,549,238,927
119137,Moorpark College,14206,8561,5708,8498
239372,Moraine Park Technical College,6613,2959,1112,5501
147378,Moraine Valley Community College,16106,9900,6764,9342
214157,Moravian College,1837,1597,1447,390
157386,Morehead State University,11358,8401,6472,4886
140553,Morehouse College,2170,2070,2006,164
140562,Morehouse School of Medicine,372,368,366,6
460394,Moreno Valley College,8420,4139,1976,6444
127617,Morgan Community College,1851,904,425,1426
163453,Morgan State University,7546,6655,6101,1445
237570,Morgantown Beauty College Inc,68,68,68,0
154004,Morningside College,2542,1760,1275,1267
218399,Morris College,824,820,817,7
365763,Morris County Vocational School District,53,53,53,0
147396,Morrison Institute of Technology,103,103,103,0
182430,Morrison University,411,404,399,12
196051,Morrisville State College,3028,2813,2668,360
147411,Morton College,4886,2672,1553,3333
221096,Motlow State Community College,4900,2960,1979,2921
414124,Motoring Technical Training Institute,298,282,271,27
479062,MotoRing Technical Training Institute,10,10,10,0
169275,Mott Community College,9683,5179,2903,6780
140599,Moultrie Technical College,2058,1215,789,1269
214166,Mount Aloysius College,1835,1496,1277,558
209241,Mount Angel Seminary,170,162,157,13
204176,Mount Carmel College of Nursing,1121,896,752,369
166939,Mount Holyoke College,2251,2212,2188,63
166948,Mount Ida College,1288,1220,1176,112
219198,Mount Marty College,1225,877,652,573
239390,Mount Mary University,1481,1230,1070,411
154013,Mount Mercy University,1761,1294,995,766
199069,Mount Olive College,3414,2183,1386,2028
193353,Mount Saint Mary College,2556,2101,1811,745
119173,Mount St Mary's College,3274,2806,2508,766
163462,Mount St Mary's University,2240,2035,1907,333
204194,Mount Vernon Nazarene University,2229,1886,1667,562
166957,Mount Wachusett Community College,4734,2918,2000,2734
182865,Mount Washington College,2284,1779,1453,831
232788,Mountain Empire Community College,2924,1852,1310,1614
237598,Mountain State College,153,146,141,12
448275,Mountain State School of Massage,21,21,21,0
226930,Mountain View College,8797,4251,1954,6843
448248,Mountainland Applied Technology College,1959,826,253,1706
185624,Mountainside School of Nursing,116,116,116,0
444954,Mountwest Community and Technical College,2257,1689,1402,855
171261,Mr Bela's School of Cosmetology Inc,117,90,73,44
417576,Mr Bernard's School of Hair Fashion Inc,132,125,121,11
147439,Mr John's School of Cosmetology Esthetics & Nails-Decatur,86,78,72,14
443173,Mr John's School of Cosmetology Esthetics & Nails-Jacksonville,39,37,36,3
436100,Mr Leon's School of Hair Design-Lewiston,34,34,34,0
142416,Mr Leon's School of Hair Design-Moscow,25,25,25,0
376631,Mr Wayne's School of Unisex Hair Design,37,31,27,10
249061,Ms Robert's Academy of Beauty Culture-Villa Park,93,70,55,38
382258,Mt Diablo Adult Education,176,110,76,100
209250,Mt Hood Community College,9393,5981,4256,5137
119164,Mt San Antonio College,28481,16536,10499,17982
119216,Mt San Jacinto Community College District,14170,8148,5105,9065
398130,Mt Sierra College,538,418,340,198
118189,MTI Business College Inc,138,138,138,0
118198,MTI College,594,594,594,0
119234,Mueller College,105,56,24,81
214175,Muhlenberg College,2448,2372,2323,125
185651,Muhlenberg Harold B and Dorothy A Snyder Schools-School of Imaging,100,51,19,81
185679,Muhlenberg Harold B and Dorothy A Snyder Schools-School of Nursing,361,161,29,332
209287,Multnomah University,777,675,611,166
207236,Murray State College,2343,1497,1070,1273
157401,Murray State University,10943,9046,7838,3105
119270,Musicians Institute,1204,1103,1037,167
171304,Muskegon Community College,4879,2771,1705,3174
204264,Muskingum University,2154,1754,1501,653
457606,My Le's Beauty College,35,35,35,0
439747,My Le's Beauty College,33,29,26,7
451228,MyComputerCareer.com-Indianapolis,208,208,208,0
480037,MyComputerCareer.com-Raleigh,496,496,496,0
451477,MyComputerCareer.com-TechSkills,292,292,292,0
406486,Myotherapy College of Utah,63,40,25,38
434432,Myotherapy Institute,23,23,23,0
448123,MyrAngel Beauty Institute,120,120,120,0
119331,Napa Valley College,6308,3696,2376,3932
127653,Naropa University,992,873,799,193
442611,NASCAR Technical Institute,1510,1510,1510,0
199087,Nash Community College,3279,2121,1536,1743
239424,Nashotah House,124,110,101,23
183141,Nashua Community College,2242,1254,754,1488
461564,Nashville Barber and Style Academy,59,31,13,46
221157,Nashville College of Medical Careers,164,164,164,0
221184,Nashville State Community College,10007,5580,3343,6664
193478,Nassau Community College,23318,17267,14209,9109
178262,National Academy of Beauty Arts-Farmington,127,127,127,0
178484,National Academy of Beauty Arts-St Louis,176,176,176,0
248882,National American University-Albuquerque,397,187,51,346
440758,National American University-Albuquerque West,346,154,29,317
451875,National American University-Austin,254,114,24,230
482307,National American University-Austin South,120,49,3,117
477996,National American University-Bellevue,227,93,7,220
436483,National American University-Bloomington,509,253,88,421
440767,National American University-Brooklyn Center,756,324,45,711
478005,National American University-Burnsville,161,68,8,153
466161,National American University-Centennial,139,59,8,131
127680,National American University-Colorado Springs,281,145,57,224
466189,National American University-Colorado Springs South,262,141,63,199
127699,National American University-Denver,258,135,55,203
440749,National American University-Ellsworth AFB Extension,292,143,47,245
482325,National American University-Georgetown,173,79,18,155
247700,National American University-Independence,633,266,28,605
482370,National American University-Indianapolis,198,80,3,195
466170,National American University-Lee's Summit,360,146,7,353
482316,National American University-Lewisville,158,64,4,154
478014,National American University-Mesquite,189,82,12,177
442718,National American University-Overland Park,470,238,88,382
219204,National American University-Rapid City,2306,1098,321,1985
482334,National American University-Richardson,197,79,3,194
482343,National American University-Rochester,149,60,2,147
174385,National American University-Roseville,371,159,22,349
219213,National American University-Sioux Falls,659,306,78,581
482389,National American University-Tigard,46,18,0,46
466152,National American University-Tulsa,251,102,5,246
482352,National American University-Weldon Spring,90,36,1,89
451884,National American University-Wichita,375,159,19,356
482361,National American University-Wichita West,282,136,42,240
448585,National American University-Zona Rosa,477,224,61,416
165635,National Aviation Academy of New England,247,247,247,0
378956,National Aviation Academy of Tampa Bay,692,692,692,0
440077,National Beauty College,50,50,50,0
204334,National Beauty College,78,78,78,0
454847,National Beauty College,63,63,63,0
455868,National Career College,43,43,43,0
371964,National Career Education,51,51,51,0
457767,National Career Institute,176,176,176,0
209296,National College of Natural Medicine,558,535,521,37
480480,National College-Canton,89,85,83,6
453473,National College-Cincinnati,137,101,77,60
457004,National College-Columbus,99,80,67,32
453455,National College-Dayton,167,130,105,62
157021,National College-Lexington,1282,986,794,488
388043,National College-Nashville,710,585,503,207
453482,National College-Stow,82,66,56,26
459833,National College-Willoughby Hills,66,52,43,23
453464,National College-Youngstown,130,111,98,32
131830,National Conservatory of Dramatic Arts,37,37,37,0
441478,National Graduate School of Quality Management,142,142,142,0
119553,National Holistic Institute,764,747,735,29
412003,National Institute of Massotherapy,56,51,48,8
434034,National Labor College,623,265,33,590
148955,National Latino Education Institute,64,64,64,0
147536,National Louis University,4814,3211,2209,2605
448114,National Massage Therapy Institute,599,591,586,13
461023,National Paralegal College,1089,1073,1063,26
106980,National Park Community College,3246,2103,1525,1721
462327,National Personal Training Institute of Colorado,78,78,78,0
462318,National Personal Training Institute of Colorado,115,115,115,0
481544,National Personal Training Institute of Columbus,75,30,0,75
447759,National Polytechnic College,234,234,234,0
375106,National Tractor Trailer School Inc-Buffalo,89,84,81,8
367334,National Tractor Trailer School Inc-Liverpool,179,140,114,65
119605,National University,18207,12510,8877,9330
242981,National University College-Arecibo,1650,1331,1124,526
242972,National University College-Bayamon,5213,4188,3525,1688
468723,National University College-Caguas,920,793,711,209
458469,National University College-Ponce,1118,988,904,214
444042,National University College-Rio Grande,1869,1357,1025,844
147590,National University of Health Sciences,786,733,699,87
405021,Nationwide Beauty Academy,57,57,57,0
129729,Naugatuck Valley Community College,7294,4178,2603,4691
187596,Navajo Technical University,1956,1547,1271,685
119678,Naval Postgraduate School,2870,2107,1674,1196
227146,Navarro College,10256,6398,4448,5808
127714,Nazarene Bible College,889,455,174,715
178518,Nazarene Theological Seminary,255,157,97,158
193584,Nazareth College,2823,2497,2293,530
479424,NCP College of Nursing-Hayward,88,88,88,0
476799,NCP College of Nursing-South San Francisco,73,73,73,0
181376,Nebraska Christian College,150,135,126,24
181765,Nebraska College of Technical Agriculture,300,243,214,86
181419,Nebraska Indian Community College,199,137,106,93
181297,Nebraska Methodist College of Nursing & Allied Health,943,727,588,355
181446,Nebraska Wesleyan University,2149,1837,1639,510
193609,Neighborhood Playhouse School of the Theater,87,87,87,0
227155,Neilson Beauty College,51,27,12,39
178527,Neosho Beauty College,44,40,38,6
155566,Neosho County Community College,2667,1516,934,1733
163532,Ner Israel Rabbinical College,523,512,505,18
214272,Neumann University,2956,2477,2173,783
445692,Neumont University,420,420,420,0
414939,Nevada Career Institute,272,272,272,0
417673,Nevada Regional Technical Center,19,18,18,1
441900,Nevada State College,3377,2078,1199,2178
449685,New Age Training,124,124,124,0
101277,New Beginning College of Cosmetology,89,89,89,0
185758,New Brunswick Theological Seminary,171,84,30,141
367431,New Castle Beauty Academy,34,34,34,0
214290,New Castle School of Trades,856,856,856,0
262129,New College of Florida,793,793,793,0
439774,New Concept Massage and Beauty School,39,32,28,11
221980,New Concepts School of Cosmetology,124,50,2,122
476823,New Dimensions Beauty Academy Inc,46,44,42,4
419280,New Dimensions School of Hair Design,51,34,22,29
182980,New England College,2224,2140,2087,137
164438,New England College of Business and Finance,1145,630,298,847
167093,New England College of Optometry,502,500,498,4
230977,New England Culinary Institute,462,392,347,115
373678,New England Hair Academy,168,137,117,51
217305,New England Institute of Technology,2933,2631,2436,497
167181,New England School of Acupuncture,179,150,132,47
373827,New England School of Communications,457,440,429,28
182999,New England School of Hair Design Inc,57,55,54,3
167215,New England School of Law,964,786,676,288
167224,New England School of Photography,66,66,66,0
129932,New England Tractor Trailer Training School of Connecticut,302,216,160,142
480903,New England Tractor Trailer Training School of CT-Bridgeport,259,245,236,23
468963,New England Tractor Trailer Training School of Massachusetts,219,219,219,0
217323,New England Tractor Trailer Training School of Rhode Island,157,157,157,0
183035,New Hampshire Institute for Therapeutic Arts,32,32,32,0
430810,New Hampshire Institute of Art,506,471,449,57
208725,New Hope Christian College-Eugene,179,164,154,25
457484,New Hope Christian College-Honolulu,147,110,87,60
185129,New Jersey City University,8442,6445,5204,3238
185828,New Jersey Institute of Technology,10130,8394,7305,2825
457828,New Life Business Institute,42,42,42,0
444778,New Life Theological Seminary,163,98,56,107
187897,New Mexico Highlands University,3690,2786,2224,1466
187967,New Mexico Institute of Mining and Technology,2134,1833,1651,483
187903,New Mexico Junior College,2320,1403,940,1380
187912,New Mexico Military Institute,470,470,470,0
187994,New Mexico State University-Alamogordo,2458,1406,875,1583
188003,New Mexico State University-Carlsbad,1861,980,534,1327
187620,New Mexico State University-Dona Ana,8837,5755,4197,4640
188021,New Mexico State University-Grants,970,544,329,641
188030,New Mexico State University-Main Campus,16765,14461,13006,3759
159948,New Orleans Baptist Theological Seminary,2638,1568,894,1744
434469,New Professions Technical Institute,67,44,29,38
447582,New River Community and Technical College,2551,1957,1657,894
232867,New River Community College,4808,2868,1887,2921
440396,New Saint Andrews College,178,166,159,19
193672,New School of Radio and Television,58,58,58,0
107442,New Tyler Barber College Inc,79,79,79,0
366368,New York Academy of Art,104,104,104,0
440262,New York Automotive and Diesel Institute,276,276,276,0
195845,New York Career Institute,614,451,343,271
193751,New York Chiropractic College,923,799,723,200
418126,New York College of Health Professions,782,587,462,320
194073,New York College of Podiatric Medicine,382,381,380,2
439783,New York College of Traditional Chinese Medicine,150,107,80,70
421841,New York Conservatory for Dramatic Arts,273,273,273,0
461148,New York Film Academy,1717,1717,1717,0
481243,New York Institute of Beauty,80,49,28,52
193788,New York Institute of English and Business,247,236,229,18
431071,New York Institute of Massage Inc,103,76,58,45
194091,New York Institute of Technology,7545,6616,6028,1517
193821,New York Law School,1261,1009,854,407
457800,New York Medical Career Training Center,363,198,90,273
193830,New York Medical College,1427,1249,1139,288
451413,New York Methodist Hospital Center for Allied Health Education,155,155,155,0
193858,New York School for Medical and Dental Assistants,328,328,328,0
475404,New York School of Esthetics & Day Spa,80,58,43,37
194116,New York School of Interior Design,589,410,295,294
193894,New York Theological Seminary,396,274,198,198
193900,New York University,44599,38740,35096,9503
218414,Newberry College,1039,1020,1007,32
119845,Newberry School of Beauty,153,122,102,51
167251,Newbury College,962,895,851,111
155335,Newman University,3736,2233,1275,2461
217350,Newport School of Hairdressing-Main Campus,36,14,0,36
119775,Newschool of Architecture and Design,514,472,445,69
183099,NHTI-Concord's Community College,4288,2700,1897,2391
193946,Niagara County Community College,6630,5001,4178,2452
193973,Niagara University,4056,3617,3342,714
159966,Nicholls State University,6532,5569,4947,1585
167260,Nichols College,1459,1263,1138,321
239442,Nicolet Area Technical College,1271,841,623,648
444787,Nightingale College,86,86,86,0
147642,Niles School of Cosmetology,78,41,16,62
460464,Norco College,9648,4747,2270,7378
232937,Norfolk State University,6728,5942,5428,1300
174428,Normandale Community College,9508,5848,3998,5510
162371,North American Trade Schools,545,545,545,0
461795,North American University,378,353,338,40
107460,North Arkansas College,2167,1444,1079,1088
167297,North Bennet Street School,161,161,161,0
199102,North Carolina A & T State University,10561,9652,9086,1475
199157,North Carolina Central University,8093,7147,6550,1543
199193,North Carolina State University at Raleigh,34009,29517,26770,7239
199209,North Carolina Wesleyan College,1602,1377,1232,370
147660,North Central College,3048,2824,2682,366
418889,North Central Institute,134,107,89,45
155593,North Central Kansas Technical College,844,639,535,309
171395,North Central Michigan College,2790,1534,899,1891
179715,North Central Missouri College,1774,1211,926,848
204422,North Central State College,2958,1555,846,2112
224110,North Central Texas College,10335,5989,3792,6543
174437,North Central University,1305,1173,1088,217
194028,North Country Community College,2088,1333,951,1137
200305,North Dakota State College of Science,3168,2201,1712,1456
200332,North Dakota State University-Main Campus,14629,12874,11798,2831
454892,North Florida Academy,32,24,19,13
136145,North Florida Community College,1179,716,482,697
447892,North Florida Cosmetology Institute Inc,167,143,128,39
140678,North Georgia Technical College,2441,1502,1027,1414
218441,North Greenville University,2466,2244,2102,364
174376,North Hennepin Community College,7562,3950,2125,5437
142443,North Idaho College,6029,4062,3068,2961
154059,North Iowa Area Community College,3207,2114,1561,1646
227191,North Lake College,11365,5494,2526,8839
147679,North Park University,3136,2419,1970,1166
167312,North Shore Community College,7750,4607,3018,4732
448211,North West Beauty School,45,29,19,26
372028,North-West College-Glendale,177,177,177,0
120087,North-West College-Pasadena,193,193,193,0
120069,North-West College-Pomona,280,280,280,0
445364,North-West College-Riverside,392,392,392,0
120078,North-West College-West Covina,550,550,550,0
214379,Northampton County Area Community College,10666,6689,4679,5987
239460,Northcentral Technical College,4384,2707,1859,2525
444130,Northcentral University,10928,7135,4786,6142
449719,Northcoast Medical Training Academy,202,202,202,0
101897,Northeast Alabama Community College,2834,1915,1450,1384
181491,Northeast Community College,5145,3189,2200,2945
154110,Northeast Iowa Community College-Calmar,5201,2979,1856,3345
176169,Northeast Mississippi Community College,3271,2898,2710,561
204477,Northeast Ohio Medical University,832,827,824,8
221908,Northeast State Community College,5893,4045,3111,2782
461962,Northeast Technical Institute,462,349,274,188
420459,Northeast Technology Center-Afton,397,186,80,317
456560,Northeast Technology Center-Claremore,183,89,41,142
432074,Northeast Technology Center-Kansas,200,111,66,134
418339,Northeast Technology Center-Pryor,384,165,55,329
227225,Northeast Texas Community College,3225,1817,1106,2119
239488,Northeast Wisconsin Technical College,10441,5864,3551,6890
383400,Northeastern Hospital School of Nursing,72,72,72,0
147776,Northeastern Illinois University,10821,7533,5415,5406
127732,Northeastern Junior College,1962,1300,966,996
207290,Northeastern Oklahoma A&M College,2347,1946,1744,603
439817,Northeastern Seminary,170,135,113,57
207263,Northeastern State University,8548,6816,5695,2853
217837,Northeastern Technical College,1153,794,612,541
167358,Northeastern University,20053,18758,17957,2096
482705,Northeastern University Global Network,8479,4333,1727,6752
105330,Northern Arizona University,26594,22875,20533,6061
147697,Northern Baptist Theological Seminary,205,152,119,86
459134,Northern California Institute of Cosmetology Inc,44,25,13,31
167376,Northern Essex Community College,7352,4088,2438,4914
147703,Northern Illinois University,21138,17976,16053,5085
204431,Northern Institute of Cosmetology,33,33,33,0
157447,Northern Kentucky University,15263,12413,10597,4666
161484,Northern Maine Community College,1086,737,561,525
240790,Northern Marianas College,1109,993,914,195
171456,Northern Michigan University,8918,8073,7537,1381
188058,Northern New Mexico College,1681,1168,822,859
207281,Northern Oklahoma College,4909,3208,2348,2561
219259,Northern State University,3275,2252,1588,1687
418588,Northern Tier Career Center,39,39,39,0
232946,Northern Virginia Community College,51803,30478,19700,32103
461412,Northern Virginia School of Therapeutic Massage,96,38,0,96
129349,Northhaven Academy,156,138,126,30
431691,Northland Career Center,36,36,36,0
239512,Northland College,552,543,538,14
174473,Northland Community and Technical College,3792,2411,1713,2079
239503,Northland International University,327,283,255,72
105349,Northland Pioneer College,3233,1533,674,2559
217606,Northpoint Bible College,409,355,320,89
160667,Northshore Technical Community College,3151,1774,1078,2073
443030,NorthShore University HealthSystem School of Nurse Anesthesia,59,59,59,0
367459,NorthWest Arkansas Community College,8020,4581,2843,5177
445948,Northwest Career College,207,204,202,5
209409,Northwest Christian University,660,588,541,119
240657,Northwest College,1880,1349,1080,800
377546,Northwest College of Art & Design,94,91,89,5
209083,Northwest College-Beaverton,100,100,100,0
209205,Northwest College-Clackamas,141,141,141,0
468246,Northwest College-Eugene,224,224,224,0
441168,Northwest College-Hillsboro,85,85,85,0
468255,Northwest College-Tualatin,152,152,152,0
369686,Northwest Educational Center,169,169,169,0
136233,Northwest Florida State College,6708,4304,2677,4031
236027,Northwest Hair Academy,160,160,160,0
434362,Northwest HVAC/R Training Center,43,43,43,0
380377,Northwest Indian College,681,581,514,167
460941,Northwest Institute of Literary Arts,42,39,37,5
154129,Northwest Iowa Community College,1628,966,631,997
155618,Northwest Kansas Technical College,626,471,392,234
160010,Northwest Louisiana Technical College,2694,1575,1009,1685
176178,Northwest Mississippi Community College,7871,6599,5956,1915
178624,Northwest Missouri State University,6485,5791,5362,1123
209348,Northwest Nannies Institute,21,21,21,0
142461,Northwest Nazarene University,2246,1907,1692,554
448105,Northwest Regional Technology Institute,18,18,18,0
458140,Northwest School of Wooden Boat Building,52,52,52,0
204440,Northwest State Community College,4603,2075,798,3805
173115,Northwest Technical College,1216,694,430,786
107488,Northwest Technical Institute,252,247,244,8
178606,Northwest Technical School,13,4,0,13
366623,Northwest Technology Center-Alva,108,41,7,101
407601,Northwest Technology Center-Fairview,97,35,3,94
236133,Northwest University,1733,1552,1436,297
420398,Northwest Vista College,15965,7952,3902,12063
101736,Northwest-Shoals Community College,3854,2516,1840,2014
154101,Northwestern College,1233,1172,1133,100
147749,Northwestern College-Chicago Campus,430,312,235,195
260992,Northwestern College-Southwestern Campus,756,506,342,414
130040,Northwestern Connecticut Community College,1549,824,457,1092
174507,Northwestern Health Sciences University,904,830,783,121
171483,Northwestern Michigan College,4724,3070,1951,2773
207306,Northwestern Oklahoma State University,2307,1882,1605,702
120166,Northwestern Polytechnic University,988,895,837,151
160038,Northwestern State University of Louisiana,8944,6704,5249,3695
168573,Northwestern Technological Institute,406,406,406,0
147767,Northwestern University,21592,18880,17190,4402
136206,Northwood University-Florida,646,591,555,91
171492,Northwood University-Michigan,3194,2427,1934,1260
227243,Northwood University-Texas,713,604,535,178
130004,Norwalk Community College,6556,3649,2180,4376
431707,Norwich Technical High School,31,31,31,0
230995,Norwich University,3417,3240,3126,291
368452,Nossi College of Art,279,279,279,0
204468,Notre Dame College,2269,1741,1405,864
120184,Notre Dame de Namur University,2030,1442,1071,959
163578,Notre Dame of Maryland University,2877,1656,888,1989
160029,Notre Dame Seminary Graduate School of Theology,184,138,109,75
409032,Nouvelle Institute,116,116,116,0
459426,Nova Academy of Cosmetology,84,78,74,10
428055,Nova College de Puerto Rico,195,195,195,0
136215,Nova Southeastern University,25670,18100,13390,12280
443207,NTMA Training Centers of Southern California,242,242,242,0
158884,Nunez Community College,2506,1451,918,1588
157456,Nutek Academy of Beauty Inc,18,18,18,0
447980,Nuvo College of Cosmetology,44,40,37,7
194161,Nyack College,3082,2437,2033,1049
203614,O C Collins Career Center,407,385,374,33
231004,O'Briens Aveda Institute,80,80,80,0
221254,O'More College of Design,180,159,146,34
174525,Oak Hills Christian College,143,130,122,21
152099,Oakland City University,2418,1249,494,1924
171535,Oakland Community College,26405,14218,8058,18347
171571,Oakland University,20169,16326,13863,6306
147800,Oakton Community College,10866,5625,2976,7890
101912,Oakwood University,1903,1847,1810,93
204501,Oberlin College,2911,2887,2872,39
227289,Oblate School of Theology,125,91,70,55
120254,Occidental College,2128,2119,2113,15
227298,Ocean Corporation,360,360,360,0
185873,Ocean County College,9477,6595,5138,4339
431716,Ocean County Vocational-Technical School,522,522,522,0
120272,Oceanside College of Beauty,70,70,70,0
420431,Oconee Fall Line Technical College,1869,995,554,1315
227304,Odessa College,5059,2644,1423,3636
147819,Oehrlein School of Cosmetology,70,70,70,0
230490,Ogden-Weber Applied Technology College,2625,1259,569,2056
366465,Ogeechee Technical College,2216,1311,854,1362
219277,Oglala Lakota College,1551,1152,884,667
227313,Ogle School Hair Skin Nails-Arlington,212,174,149,63
381404,Ogle School Hair Skin Nails-Dallas,231,171,131,100
478591,Ogle School Hair Skin Nails-Denton,151,114,90,61
227322,Ogle School Hair Skin Nails-Ft Worth,223,176,145,78
248703,Ogle School Hair Skin Nails-Hurst,161,119,92,69
460978,Ogle School Hair Skin Nails-North Dallas,154,127,109,45
480125,Ogle School Hair Skin Nails-San Antonio,170,144,127,43
140696,Oglethorpe University,1100,1037,996,104
481827,Ohio Business College-Dayton,54,36,24,30
453747,Ohio Business College-Hilliard,165,141,126,39
203739,Ohio Business College-Sandusky,387,274,200,187
203720,Ohio Business College-Sheffield,415,358,320,95
418269,Ohio Center for Broadcasting-Cincinnati,19,19,19,0
453756,Ohio Center for Broadcasting-Columbus,102,102,102,0
410797,Ohio Center for Broadcasting-Valley View,172,172,172,0
201964,Ohio Christian University,3711,2586,1859,1852
204592,Ohio College of Massotherapy Inc,103,85,73,30
204617,Ohio Dominican University,2573,2130,1845,728
407504,Ohio Hi Point Joint Vocational School District,32,32,32,0
206002,Ohio Mid-Western College,140,137,135,5
204635,Ohio Northern University,3619,3303,3098,521
204714,Ohio State Beauty Academy,171,171,171,0
204723,Ohio State College of Barber Styling,142,142,142,0
204778,Ohio State School of Cosmetology-Canal Winchester,89,89,89,0
405012,Ohio State School of Cosmetology-Westerville,79,79,79,0
204662,Ohio State University Agricultural Technical Institute,643,584,554,89
204671,Ohio State University-Lima Campus,1077,959,880,197
204796,Ohio State University-Main Campus,57466,52883,50012,7454
204680,Ohio State University-Mansfield Campus,1204,1072,985,219
204699,Ohio State University-Marion Campus,1259,1088,973,286
204705,Ohio State University-Newark Campus,2315,2062,1893,422
204608,Ohio Technical College,1119,1119,1119,0
453817,Ohio Technical College-PowerSport Institute,267,267,267,0
204820,Ohio University-Chillicothe Campus,2330,1617,1135,1195
204802,Ohio University-Eastern Campus,1091,709,451,640
204848,Ohio University-Lancaster Campus,2596,1776,1222,1374
204857,Ohio University-Main Campus,28786,23109,19449,9337
204839,Ohio University-Southern Campus,2012,1448,1066,946
204866,Ohio University-Zanesville Campus,2042,1352,885,1157
204884,Ohio Valley College of Technology,183,165,153,30
237640,Ohio Valley University,451,409,383,68
204909,Ohio Wesleyan University,1830,1817,1809,21
120290,Ohlone College,10310,5600,3219,7091
194189,Ohr Hameir Theological Seminary,94,94,94,0
248776,Okefenokee Technical College,1180,650,382,798
207403,Oklahoma Baptist University,2097,1996,1931,166
207324,Oklahoma Christian University,2421,2233,2116,305
207449,Oklahoma City Community College,13491,7596,4617,8874
207458,Oklahoma City University,3179,2807,2573,606
207351,Oklahoma Panhandle State University,1375,1176,1041,334
207537,Oklahoma School of Photography,44,44,44,0
207315,Oklahoma State University Center for Health Sciences,475,449,434,41
207564,Oklahoma State University Institute of Technology,3618,2776,2207,1411
207388,Oklahoma State University-Main Campus,26073,22290,19959,6114
207397,Oklahoma State University-Oklahoma City,6996,4166,2251,4745
469629,Oklahoma Technical College,182,182,182,0
206835,Oklahoma Wesleyan University,1355,882,578,777
232982,Old Dominion University,24828,20001,16957,7871
478643,Old Town Barber College-Topeka,28,28,28,0
155353,Old Town Barber College-Wichita,40,40,40,0
455859,Oliver Finley Academy of Cosmetology,192,192,192,0
171599,Olivet College,1133,1041,982,151
147828,Olivet Nazarene University,4579,3722,3185,1394
145707,Olney Central College,1470,945,680,790
187505,Olympian University of Cosmetology,1017,1017,1017,0
236188,Olympic College,7329,5515,4287,3042
407328,Omaha School of Massage and Healthcare of Herzing University,121,114,110,11
185916,Omega Institute,142,118,102,40
439844,Omega Institute of Cosmetology,67,67,67,0
455026,Omega Studios' School of Applied Recording Arts & Sciences,96,38,0,96
444796,Omnitech Institute,92,92,92,0
194222,Onondaga Community College,12834,8653,6540,6294
440730,Onondaga Cortland Madison BOCES,503,503,503,0
460455,Onondaga School of Therapeutic Massage-Rochester,61,30,9,52
457846,Onondaga School of Therapeutic Massage-Syracuse,74,38,14,60
159601,Opelousas School of Cosmetology Inc,14,14,14,0
237613,Opportunities Industrialization Center,96,96,96,0
207582,Oral Roberts University,3414,3077,2862,552
120342,Orange Coast College,21886,12992,8497,13389
194240,Orange County Community College,7029,4577,3338,3691
417992,Orange Ulster BOCES-Practical Nursing Program,54,45,40,14
218487,Orangeburg Calhoun Technical College,2718,1739,1244,1474
423652,Oregon Coast Community College,580,317,184,396
209533,Oregon College of Art and Craft,156,142,133,23
369659,Oregon College of Oriental Medicine,224,212,204,20
209490,Oregon Health & Science University,2838,2046,1557,1281
209506,Oregon Institute of Technology,4407,3192,2370,2037
209542,Oregon State University,27902,24303,21958,5944
440828,Oregon State University-Cascades Campus,934,548,291,643
136303,Orlando Tech,540,331,225,315
441593,Orleans Niagara BOCES-Practical Nursing Program,33,33,33,0
214528,Orleans Technical Institute,548,456,396,152
407434,Orlo School of Hair Design and Cosmetology,99,82,71,28
364964,Oswego County BOCES,134,93,72,62
127778,Otero Junior College,1449,938,679,770
120403,Otis College of Art and Design,1086,1071,1061,25
194259,Otsego Area BOCES-Practical Nursing Program,37,37,37,0
442897,Ottawa University-Jeffersonville,114,44,0,114
155636,Ottawa University-Kansas City,356,139,0,356
428259,Ottawa University-Milwaukee,341,135,3,338
454582,Ottawa University-Online,458,180,1,457
155627,Ottawa University-Ottawa,558,537,523,35
105367,Ottawa University-Phoenix,653,257,6,647
204936,Otterbein University,2919,2608,2411,508
107512,Ouachita Baptist University,1543,1521,1507,36
160065,Our Lady of Holy Cross College,1112,801,602,510
160074,Our Lady of the Lake College,1703,1282,1011,692
227331,Our Lady of the Lake University,2927,2665,2498,429
204945,Owens Community College,14691,8301,5072,9619
247940,Owensboro Community and Technical College,4286,2665,1845,2441
455798,Oxford Academy of Hair Design,107,76,56,51
461120,Oxford Graduate School,113,113,113,0
120421,Oxnard College,6939,3614,1933,5006
178679,Ozark Christian College,751,691,652,99
107549,Ozarka College,1489,1080,873,616
177472,Ozarks Technical Community College,14798,9651,7049,7749
185970,P B Cosmetology Education Center,180,150,130,50
443225,P C Age-Edison,65,65,65,0
443216,P C Age-Jersey City,196,196,196,0
391005,P&A Scholars Beauty School,241,241,241,0
214838,Pace Institute,65,65,65,0
194310,Pace University-New York,12624,10489,9148,3476
446437,Pacific Coast Trade School,401,321,268,133
422695,Pacific College,277,277,277,0
442842,Pacific College of Oriental Medicine-Chicago,219,162,126,93
414595,Pacific College of Oriental Medicine-New York,602,492,422,180
378576,Pacific College of Oriental Medicine-San Diego,510,384,305,205
439862,Pacific Islands University,79,66,57,22
120740,Pacific Lutheran Theological Seminary,99,93,90,9
236230,Pacific Lutheran University,3462,3302,3201,261
209603,Pacific Northwest College of Art,517,482,460,57
455406,Pacific Northwest University of Health Sciences,359,357,355,4
120768,Pacific Oaks College,1072,464,81,991
120795,Pacific School of Religion,183,143,118,65
120838,Pacific States University,173,173,173,0
120865,Pacific Union College,1647,1531,1456,191
209612,Pacific University,3583,3419,3316,267
115746,Pacifica Graduate Institute,1060,770,590,470
130110,Paier College of Art Inc,155,129,112,43
140720,Paine College,924,872,838,86
447731,Palace Beauty College,148,106,78,70
243647,Palau Community College,646,494,417,229
447722,Palladium Technical Academy,73,73,73,0
449490,Palm Beach Academy of Health & Beauty,113,113,113,0
136330,Palm Beach Atlantic University,3764,3291,2989,775
136358,Palm Beach State College,29763,17653,9460,20303
154174,Palmer College of Chiropractic-Davenport,2135,2113,2100,35
475538,Palmetto Beauty School,65,62,60,5
246354,Palo Alto College,8427,3759,1399,7028
120698,Palo Alto University,948,900,870,78
120953,Palo Verde College,3253,1374,424,2829
120971,Palomar College,24665,13762,8252,16413
365125,Palomar Institute of Cosmetology,136,136,136,0
199263,Pamlico Community College,597,334,201,396
475413,Panache Academy of Beauty,45,41,39,6
227386,Panola College,2699,1788,1327,1372
364016,Paradise Valley Community College,9477,4956,2671,6806
204963,Paramount Beauty Academy,101,71,52,49
121628,Pardee RAND Graduate School,102,102,102,0
121017,Paris Beauty College,99,56,28,71
365073,Paris II Educational Center,94,78,68,26
227401,Paris Junior College,5301,3420,2470,2831
186016,Parisian Beauty School,337,270,226,111
460561,Park Avenue School of Cosmetology,53,53,53,0
178721,Park University,10978,5023,1184,9794
457758,Park West Barber School,175,116,77,98
243823,Parker University,922,859,819,103
147916,Parkland College,8437,4925,3150,5287
235158,Paroba College of Cosmetology,109,109,109,0
121044,Pasadena City College,25268,14769,9463,15805
136400,Pasco-Hernando Community College,10206,6086,4004,6202
186034,Passaic County Community College,9129,5303,3369,5760
160117,Pat Goins Benton Road Beauty School,25,25,25,0
160126,Pat Goins Monroe Beauty School,28,28,28,0
160135,Pat Goins Ruston Beauty School,28,28,28,0
157508,Pat Wilson's Beauty College,73,56,44,29
233019,Patrick Henry Community College,3163,2049,1486,1677
233037,Paul D Camp Community College,1392,756,435,957
107789,Paul Mitchell the School-Arkansas,96,88,82,14
475486,Paul Mitchell the School-Arlington,237,237,237,0
454926,Paul Mitchell the School-Atlanta,225,225,225,0
451565,Paul Mitchell the School-Austin,171,141,122,49
454652,Paul Mitchell the School-Birmingham,162,162,162,0
260929,Paul Mitchell the School-Boise,150,128,114,36
143376,Paul Mitchell the School-Bradley,395,340,304,91
467872,Paul Mitchell the School-Charleston,196,166,147,49
458274,Paul Mitchell the School-Chicago,305,255,222,83
455284,Paul Mitchell the School-Cincinnati,244,213,192,52
459286,Paul Mitchell the School-Colorado Springs,231,183,152,79
467863,Paul Mitchell the School-Columbia,179,156,141,38
442240,Paul Mitchell the School-Costa Mesa,188,160,141,47
128540,Paul Mitchell the School-Danbury,127,104,89,38
459301,Paul Mitchell the School-Delaware,129,104,88,41
482176,Paul Mitchell the School-Denver,111,101,94,17
459231,Paul Mitchell the School-East Bay,259,226,205,54
454607,Paul Mitchell the School-Esani,211,211,211,0
171465,Paul Mitchell the School-Escanaba,41,41,41,0
199689,Paul Mitchell the School-Fayetteville,189,159,140,49
475547,Paul Mitchell the School-Fort Myers,110,86,70,40
459198,Paul Mitchell the School-Fresno,248,215,194,54
444486,Paul Mitchell the School-Gastonia,386,323,281,105
446288,Paul Mitchell the School-Great Lakes,87,71,60,27
240240,Paul Mitchell the School-Green Bay,156,156,156,0
461591,Paul Mitchell the School-Honolulu,134,130,127,7
249238,Paul Mitchell the School-Houston,272,217,181,91
417008,Paul Mitchell the School-Huntsville,148,148,148,0
461917,Paul Mitchell the School-Indianapolis,174,144,125,49
136109,Paul Mitchell the School-Jacksonville,166,130,106,60
481508,Paul Mitchell the School-Jersey Shore,131,129,127,4
248660,Paul Mitchell the School-Knoxville,207,179,160,47
462008,Paul Mitchell the School-Las Vegas,255,211,182,73
156426,Paul Mitchell the School-Lexington,278,223,186,92
156842,Paul Mitchell the School-Louisville,247,246,245,2
449995,Paul Mitchell the School-Mclean,181,153,134,47
456029,Paul Mitchell the School-Memphis,143,143,143,0
451121,Paul Mitchell the School-Miami,119,85,62,57
449977,Paul Mitchell the School-Michigan,237,199,174,63
444608,Paul Mitchell the School-Monroe,57,57,57,0
460710,Paul Mitchell the School-Murfreesboro,180,138,110,70
220491,Paul Mitchell the School-Nashville,168,150,138,30
457545,Paul Mitchell the School-Normal,131,114,102,29
476294,Paul Mitchell the School-Ogden,107,84,69,38
445212,Paul Mitchell the School-Orlando,252,208,179,73
476984,Paul Mitchell the School-Overland Park,157,135,121,36
454768,Paul Mitchell the School-Pasadena,174,141,120,54
459116,Paul Mitchell the School-Phoenix,187,157,138,49
208187,Paul Mitchell the School-Portland,88,88,88,0
183202,Paul Mitchell the School-Portsmouth,26,26,26,0
380456,Paul Mitchell the School-Provo,132,116,106,26
475556,Paul Mitchell the School-Raleigh,147,120,102,45
476841,Paul Mitchell the School-Reno,211,177,154,57
443641,Paul Mitchell the School-Rhode Island,188,150,125,63
455761,Paul Mitchell the School-Sacramento,348,287,247,101
230214,Paul Mitchell the School-Salt Lake City,265,200,157,108
451714,Paul Mitchell the School-San Antonio,257,257,257,0
449968,Paul Mitchell the School-San Diego,301,247,211,90
441274,Paul Mitchell the School-Santa Barbara,127,103,88,39
449986,Paul Mitchell the School-Sherman Oaks,280,232,200,80
462071,Paul Mitchell the School-Spokane,239,197,170,69
455080,Paul Mitchell the School-Springfield,97,84,75,22
458487,Paul Mitchell the School-St George,161,128,107,54
461421,Paul Mitchell the School-St Louis,225,204,190,35
449959,Paul Mitchell the School-Tampa,194,146,115,79
457323,Paul Mitchell the School-Temecula,275,220,184,91
408066,Paul Mitchell the School-Wichita,121,92,73,48
480930,Paul Mitchell the School-Woodbridge,121,116,113,8
227429,Paul Quinn College,243,227,216,27
194392,Paul Smiths College of Arts and Science,981,974,969,12
204990,Payne Theological Seminary,135,98,75,60
455345,PCCenter,60,60,60,0
481085,PCCTI IT and Healthcare,233,208,191,42
154208,PCI Academy-Ames,141,141,141,0
443979,PCI Academy-Plymouth,57,46,39,18
439871,PCI College,104,104,104,0
369783,PCI Health Training Center,521,521,521,0
176239,Pearl River Community College,5170,4100,3559,1611
214883,Peirce College,1796,923,358,1438
221643,Pellissippi State Community College,10704,7055,5211,5493
236258,Peninsula College,2405,1822,1427,978
214892,Penn Commercial Business/Technical School,346,346,346,0
186052,Pennco Tech-Blackwood,703,607,543,160
214944,Pennco Tech-Bristol,551,450,384,167
214962,Pennsylvania Academy of Cosmetology Arts and Sciences-Du Bois,56,52,49,7
214546,Pennsylvania Academy of Cosmetology Arts and Sciences-Johnstown,53,48,44,9
214971,Pennsylvania Academy of the Fine Arts,299,294,291,8
215053,Pennsylvania College of Art and Design,223,214,208,15
442356,Pennsylvania College of Health Sciences,1429,877,520,909
366252,Pennsylvania College of Technology,5678,5139,4774,904
215008,Pennsylvania Gunsmith School,75,75,75,0
414911,Pennsylvania Highlands Community College,2506,1495,984,1522
261861,Pennsylvania Institute of Health and Technology,118,118,118,0
215026,Pennsylvania Institute of Taxidermy Inc,6,6,6,0
214582,Pennsylvania Institute of Technology,743,581,474,269
214616,Pennsylvania State University-College of Medicine,797,773,759,38
214777,Pennsylvania State University-Main Campus,46615,45406,44639,1976
214801,Pennsylvania State University-Penn State Abington,3694,3213,2888,806
214689,Pennsylvania State University-Penn State Altoona,3861,3732,3645,216
214698,Pennsylvania State University-Penn State Beaver,703,657,626,77
214704,Pennsylvania State University-Penn State Berks,2732,2534,2402,330
214731,Pennsylvania State University-Penn State Brandywine,1492,1349,1253,239
214740,Pennsylvania State University-Penn State Dubois,704,616,557,147
214591,Pennsylvania State University-Penn State Erie-Behrend College,4057,3849,3714,343
214759,Pennsylvania State University-Penn State Fayette- Eberly,846,731,653,193
214607,Pennsylvania State University-Penn State Great Valley,473,209,60,413
214786,Pennsylvania State University-Penn State Greater Allegheny,623,587,562,61
214713,Pennsylvania State University-Penn State Harrisburg,4441,3750,3329,1112
214768,Pennsylvania State University-Penn State Hazleton,951,909,881,70
214670,Pennsylvania State University-Penn State Lehigh Valley,925,801,719,206
214795,Pennsylvania State University-Penn State Mont Alto,1023,852,737,286
214625,Pennsylvania State University-Penn State New Kensington,680,587,524,156
214810,Pennsylvania State University-Penn State Schuylkill,837,730,658,179
214634,Pennsylvania State University-Penn State Shenango,568,417,315,253
214643,Pennsylvania State University-Penn State Wilkes-Barre,613,557,519,94
214652,Pennsylvania State University-Penn State Worthington Scranton,1178,1038,943,235
214829,Pennsylvania State University-Penn State York,1177,964,822,355
479956,Pennsylvania State University-World Campus,9631,4632,1544,8087
460914,Penrose Academy,177,177,177,0
449533,Pensacola School of Massage Therapy & Health Careers,46,46,46,0
136473,Pensacola State College,11235,7198,4467,6768
418199,Penta County Joint Vocational School,55,55,55,0
219842,Pentecostal Theological Seminary,205,153,121,84
121150,Pepperdine University,7315,6144,5414,1901
236212,Perry Technical Institute,774,774,774,0
181534,Peru State College,2422,1718,1255,1167
199306,Pfeiffer University,1860,1355,1041,819
209667,Phagans Beauty College,53,53,53,0
209676,Phagans Central Oregon Beauty College,133,133,133,0
208859,Phagans Grants Pass College of Beauty,39,39,39,0
209153,Phagans Medford Beauty School,67,67,67,0
414452,Phagans Newport Academy of Cosmetology Careers,25,25,25,0
209694,Phagans School of Beauty,49,49,49,0
209700,Phagans School of Hair Design,176,176,176,0
208655,Phagans School of Hair Design-Portland,132,132,132,0
209719,Phagans Tigard Beauty School,27,27,27,0
215123,Philadelphia College of Osteopathic Medicine,2736,2662,2617,119
215099,Philadelphia University,3523,3151,2916,607
107600,Philander Smith College,556,536,523,33
189282,Phillips Beth Israel School of Nursing,269,121,24,245
107619,Phillips Community College of the University of Arkansas,2029,1184,757,1272
110307,Phillips Graduate Institute,206,188,177,29
414966,Phillips Theological Seminary,126,74,42,84
105428,Phoenix College,12676,6528,3421,9255
447698,Phoenix Institute of Herbal Medicine & Acupuncture,124,106,95,29
381459,Phoenix Seminary,187,91,31,156
481076,Photographic Center Northwest,9,4,0,9
407513,Pickaway Ross Joint Vocational School District,374,282,236,138
128151,Pickens Technical College,1184,1098,1054,130
140818,Piedmont College,2368,1834,1501,867
199324,Piedmont Community College,1591,998,699,892
199315,Piedmont International University,384,257,177,207
218520,Piedmont Technical College,6171,3796,2596,3575
233116,Piedmont Virginia Community College,5630,2693,1208,4422
235237,Pierce College at Fort Steilacoom,6203,3943,2800,3403
439145,Pierce College at Puyallup,3396,2149,1518,1878
443492,Pierpont Community and Technical College,2683,2047,1725,958
409537,Pike County Joint Vocational School District,83,66,58,25
261773,Pike-Lincoln Technical Center,27,26,25,2
127820,Pikes Peak Community College,14634,8598,5547,9087
440794,Pillar College,418,379,353,65
105525,Pima Community College,30082,17258,10776,19306
105543,Pima Medical Institute-Albuquerque,930,930,930,0
442967,Pima Medical Institute-Albuquerque West,103,103,103,0
434140,Pima Medical Institute-Chula Vista,927,927,927,0
442134,Pima Medical Institute-Colorado Springs,547,547,547,0
404912,Pima Medical Institute-Denver,951,951,951,0
456038,Pima Medical Institute-East Valley,511,511,511,0
460136,Pima Medical Institute-Houston,898,898,898,0
445230,Pima Medical Institute-Las Vegas,1018,1018,1018,0
260691,Pima Medical Institute-Mesa,1146,1146,1146,0
449074,Pima Medical Institute-Renton,889,889,889,0
368629,Pima Medical Institute-Seattle,787,787,787,0
461689,Pima Medical Institute-South Denver,211,211,211,0
105534,Pima Medical Institute-Tucson,1726,1726,1726,0
167455,Pine Manor College,346,341,338,8
174570,Pine Technical College,1098,598,345,753
136491,Pinellas Technical Education Center-Clearwater,1044,1031,1024,20
137087,Pinellas Technical Education Center-St Petersburg,1128,1120,1116,12
160199,Pineville Beauty School,75,75,75,0
367097,Pinnacle Career Institute-Lawrence,113,113,113,0
453109,Pinnacle Career Institute-North Kansas City,161,161,161,0
177302,Pinnacle Career Institute-South Kansas City,555,555,555,0
123581,Pinnacle College,147,147,147,0
408163,Pinnacle Institute of Cosmetology,78,78,78,0
407522,Pioneer Career and Technology Center,35,34,33,2
210076,Pioneer Pacific College,1109,895,757,352
364627,Pioneer Technology Center,421,212,107,314
418913,Pipo Academy of Hair Design,11,11,11,0
444811,PITC Institute,289,234,198,91
199333,Pitt Community College,8902,6091,4670,4232
155681,Pittsburg State University,7400,6536,6006,1394
215381,Pittsburgh Institute of Aeronautics,354,354,354,0
215390,Pittsburgh Institute of Mortuary Science Inc,232,164,119,113
215415,Pittsburgh Technical Institute,1841,1841,1841,0
215424,Pittsburgh Theological Seminary,246,217,199,47
214476,Pittsburgh's Ohio Valley Hospital School of Nursing,75,56,44,31
121257,Pitzer College,1081,1059,1044,37
373216,Pivot Point Academy-Bloomingdale,175,175,175,0
445896,Pivot Point Academy-Chicago,21,21,21,0
147970,Pivot Point Academy-Evanston,179,179,179,0
156310,PJ's College of Cosmetology-Bowling Green,372,335,311,61
150853,PJ's College of Cosmetology-Clarksville,116,103,94,22
156754,PJ's College of Cosmetology-Glasgow,74,74,74,0
152150,PJ's College of Cosmetology-Richmond,37,24,15,22
260813,Platt College-Aurora,209,209,209,0
207625,Platt College-Central OKC,200,200,200,0
447388,Platt College-Dallas,88,88,88,0
428143,Platt College-Lawton,185,185,185,0
260789,Platt College-Los Angeles,608,608,608,0
447379,Platt College-Moore,172,172,172,0
445258,Platt College-North OKC,266,266,266,0
432384,Platt College-Ontario,467,467,467,0
480204,Platt College-Riverside,334,334,334,0
121275,Platt College-San Diego,370,370,370,0
245962,Platt College-Tulsa,360,360,360,0
417275,Platt Technical High School,13,13,13,0
221290,Plaza Beauty School,137,98,72,65
194499,Plaza College,726,726,726,0
183080,Plymouth State University,5236,4527,4107,1129
121309,Point Loma Nazarene University,3359,2933,2669,690
215442,Point Park University,3841,3206,2801,1040
138868,Point University,1439,1349,1291,148
390905,Polaris Career Center,350,350,350,0
136516,Polk State College,11085,6764,3841,7244
194541,Polytechnic Institute of New York University,4890,4346,4008,882
456481,Polytechnic University of Puerto Rico-Miami,120,83,59,61
456490,Polytechnic University of Puerto Rico-Orlando,125,68,32,93
121345,Pomona College,1610,1601,1596,14
372082,Pomona Unified School District Adult and Career Education,471,325,251,220
245980,Ponca City Beauty College,31,31,31,0
243072,Ponce Paramedical College Inc,2882,2781,2714,168
243081,Ponce School of Medicine and Health Sciences,669,669,669,0
241395,Pontifical Catholic University of Puerto Rico-Arecibo,986,875,805,181
243586,Pontifical Catholic University of Puerto Rico-Mayaguez,1501,1356,1263,238
241410,Pontifical Catholic University of Puerto Rico-Ponce,8341,7611,7150,1191
205027,Pontifical College Josephinum,213,212,211,2
131405,Pontifical Faculty of the Immaculate Conception at the Dominican House of Studies,119,97,84,35
455813,Pontifical John Paul II Institute for Studies on Marriage and Family,85,65,52,33
206905,Pontotoc Technology Center,117,103,96,21
178828,Poplar Bluff Technical Career Center,58,58,58,0
171775,Port Huron Cosmetology College,82,65,54,28
364636,Portage Lakes Career Center,55,55,55,0
129002,Porter and Chester Institute of Branford,298,228,182,116
130174,Porter and Chester Institute of Stratford,2630,2103,1756,874
121363,Porterville College,3810,2383,1662,2148
140827,Portfolio Center,116,116,116,0
457925,Portland Actors Conservatory,22,22,22,0
209746,Portland Community College,32411,19902,13580,18831
209807,Portland State University,28260,21615,17308,10952
130183,Post University,8082,5086,3155,4927
237701,Potomac State College of West Virginia University,1660,1439,1289,371
148007,Prairie State College,5064,3027,1997,3067
227526,Prairie View A & M University,8283,7375,6828,1455
155715,Pratt Community College,1541,1010,741,800
194578,Pratt Institute-Main,4793,4622,4514,279
430582,Praxis Institute,388,388,388,0
446455,Precision Manufacturing Institute,38,38,38,0
459152,Preferred College of Nursing-Los Angeles,159,117,89,70
475680,Preferred College of Nursing-Van Nuys,18,18,18,0
416458,Premiere Career College,557,557,557,0
218539,Presbyterian College,1433,1410,1395,38
105589,Prescott College,943,715,572,371
219295,Presentation College,791,636,536,255
481368,Prestige Health & Beauty Sciences Academy,17,17,17,0
163657,Prince George's Community College,13825,7362,4095,9730
475529,Prince Institute-Great Lakes,57,55,54,3
126924,Prince Institute-Rocky Mountains,34,34,34,0
101958,Prince Institute-Southeast,102,102,102,0
103361,Prince William Sound Community College,471,195,55,416
186122,Princeton Theological Seminary,502,479,464,38
186131,Princeton University,8014,7966,7935,79
148016,Principia College,508,497,490,18
420130,Prism Career Institute-Cherry Hill,179,179,179,0
417840,Prism Career Institute-Philadelphia,280,280,280,0
215433,Prism Career Institute-Upper Darby,315,283,262,53
430403,Prism Career Institute-West Atlantic City,42,42,42,0
139506,Pro Way Hair School,68,68,68,0
413343,Professional Beauty School,22,22,22,0
194611,Professional Business College,884,879,875,9
458016,Professional Career Training Institute,114,114,114,0
449791,Professional Careers Institute,93,93,93,0
107655,Professional Cosmetology Education Center,50,50,50,0
423397,Professional Electrical School Inc,40,40,40,0
437750,Professional Golfers Career College,265,265,265,0
454908,Professional Hands Institute,38,38,38,0
121433,Professional Institute of Beauty,108,108,108,0
446464,Professional Massage Training Center,57,57,57,0
205054,Professional Skills Institute,311,311,311,0
409193,Professional Technical Institution Inc,231,231,231,0
436702,Professional Training Centers,801,460,239,562
148098,Professional's Choice Hair Design Academy,49,41,35,14
457466,Profile Institute of Barber-Styling,60,60,60,0
461661,Progressive Training Centers,6,6,6,0
461944,Protege Academy,74,74,74,0
455770,Providence Christian College,66,66,66,0
217402,Providence College,4665,4247,3982,683
380438,Provo College,336,216,137,199
436067,Pryor Beauty College,47,47,47,0
127884,Pueblo Community College,6718,3930,2521,4197
241766,Puerto Rico Conservatory of Music,492,391,324,168
107664,Pulaski Technical College,10527,6897,5062,5465
455947,Pulse Beauty Academy-A Paul Mitchell Partner School,138,126,118,20
152248,Purdue University-Calumet Campus,9422,6855,5168,4254
243780,Purdue University-Main Campus,39794,36726,34871,4923
152266,Purdue University-North Central Campus,6102,4090,2732,3370
461713,Pure Aesthetics,37,26,19,18
419420,Putnam Career and Technical Center,126,80,57,69
431770,Putnam Westchester BOCES-Practical Nursing Program,55,32,20,35
418764,Quality Technical and Beauty College,94,94,94,0
376677,Queen City College,119,118,117,2
199412,Queens University of Charlotte,2285,1852,1579,706
439507,Quest College,355,355,355,0
167525,Quincy College,4576,2678,1718,2858
148131,Quincy University,1455,1275,1162,293
130217,Quinebaug Valley Community College,1929,1097,677,1252
130226,Quinnipiac University,8803,8063,7602,1201
167534,Quinsigamond Community College,8582,5166,3440,5142
384421,Rabbi Jacob Joseph School,86,86,86,0
194657,Rabbinical Academy Mesivta Rabbi Chaim Berlin,258,258,258,0
194693,Rabbinical College Beth Shraga,47,47,47,0
194666,Rabbinical College Bobover Yeshiva Bnei Zion,316,316,316,0
186186,Rabbinical College of America,239,239,239,0
194675,Rabbinical College of Ch'san Sofer New York,43,43,43,0
194736,Rabbinical College of Long Island,96,96,96,0
405854,Rabbinical College of Ohr Shimon Yisroel,155,155,155,0
205124,Rabbinical College Telshe,96,96,96,0
194718,Rabbinical Seminary M'kor Chaim,34,34,34,0
194763,Rabbinical Seminary of America,491,491,491,0
136659,Radford M Locklin Technical Center,744,354,157,587
233277,Radford University,9928,9457,9166,762
481119,Radians College,180,180,180,0
174604,Rainy River Community College,315,265,240,75
237491,Ralph R Willis Career and Technical Center,27,27,27,0
186201,Ramapo College of New Jersey,5852,5344,5015,837
233301,Randolph College,682,670,663,19
199421,Randolph Community College,3024,1782,1155,1869
233295,Randolph-Macon College,1315,1303,1295,20
227687,Ranger College,1893,1288,982,911
178891,Ranken Technical College,2097,1621,1313,784
363147,Raphael's School of Beauty Culture Inc-Alliance,87,47,21,66
407568,Raphael's School of Beauty Culture Inc-Boardman,124,79,50,74
363882,Raphael's School of Beauty Culture Inc-Brunswick,53,23,3,50
205142,Raphael's School of Beauty Culture Inc-Niles,145,111,88,57
233310,Rappahannock Community College,3555,1746,832,2723
186645,Raritan Valley Community College,8405,5213,3600,4805
138309,Rasmussen College-Florida,5640,4222,3304,2336
448673,Rasmussen College-Illinois,1851,1340,1010,841
480657,Rasmussen College-Kansas,135,116,103,32
175014,Rasmussen College-Minnesota,5485,3847,2787,2698
200013,Rasmussen College-North Dakota,964,698,526,438
450571,Rasmussen College-Wisconsin,1506,1098,834,672
152275,Ravenscroft Beauty College,187,148,122,65
247047,Razzle Dazzle College of Hair Design Inc,117,117,117,0
215585,Reading Area Community College,4538,2172,976,3562
215594,Reading Hospital School of Health Sciences,367,248,169,198
461698,Real Barbers College,116,108,102,14
215619,Reconstructionist Rabbinical College,48,45,43,5
250993,Red River Technology Center,448,190,59,389
127909,Red Rocks Community College,8599,4724,2765,5834
207069,Redlands Community College,2971,1516,780,2191
126605,Redstone College,434,409,392,42
209922,Reed College,1411,1377,1356,55
117052,Reedley College,13807,8175,5328,8479
215628,Reformed Presbyterian Theological Seminary,81,54,37,44
105659,Refrigeration School Inc,621,621,621,0
454351,Regency Beauty Institute-Akron,123,123,123,0
456764,Regency Beauty Institute-Arlington,96,79,68,28
447324,Regency Beauty Institute-Aurora,129,104,88,41
454467,Regency Beauty Institute-Austin,95,81,72,23
450809,Regency Beauty Institute-Avon,41,41,41,0
467526,Regency Beauty Institute-Baltimore Golden Ring,68,68,68,0
173939,Regency Beauty Institute-Blaine,137,116,102,35
174534,Regency Beauty Institute-Burnsville,112,99,90,22
458335,Regency Beauty Institute-Canton,138,110,91,47
476115,Regency Beauty Institute-Carrollwood,17,17,17,0
467614,Regency Beauty Institute-Castleton,75,64,56,19
449232,Regency Beauty Institute-Champaign,78,78,78,0
454494,Regency Beauty Institute-Charlotte,62,62,62,0
458353,Regency Beauty Institute-Chattanooga,58,52,48,10
476124,Regency Beauty Institute-Clearwater,12,12,12,0
202736,Regency Beauty Institute-Cleveland,86,86,86,0
456728,Regency Beauty Institute-Columbia,39,32,27,12
454519,Regency Beauty Institute-Columbus,92,75,63,29
467508,Regency Beauty Institute-Copperwood,89,67,52,37
467599,Regency Beauty Institute-Crystal Lake,86,76,69,17
454397,Regency Beauty Institute-Cypresswood,117,95,81,36
476151,Regency Beauty Institute-Dallas,23,23,23,0
447315,Regency Beauty Institute-Darien,58,44,35,23
454342,Regency Beauty Institute-Dayton,87,75,67,20
456746,Regency Beauty Institute-Detroit Lakeside,102,84,72,30
454360,Regency Beauty Institute-Detroit Southgate,163,138,121,42
449214,Regency Beauty Institute-Duluth,51,51,51,0
456773,Regency Beauty Institute-Durham,54,54,54,0
450854,Regency Beauty Institute-East Tucson,94,78,67,27
450872,Regency Beauty Institute-Eastgate,84,69,59,25
467535,Regency Beauty Institute-El Paso,128,109,97,31
454528,Regency Beauty Institute-Elgin,66,53,45,21
458292,Regency Beauty Institute-Evansville,65,52,44,21
449223,Regency Beauty Institute-Fairview Heights,73,73,73,0
467562,Regency Beauty Institute-Fayetteville,65,54,47,18
454379,Regency Beauty Institute-Flint,130,130,130,0
454315,Regency Beauty Institute-Fort Collins,89,76,68,21
456755,Regency Beauty Institute-Fort Myers,40,33,28,12
454388,Regency Beauty Institute-Grand Rapids,87,73,63,24
450836,Regency Beauty Institute-Greenfield,114,114,114,0
449199,Regency Beauty Institute-Greenwood,69,58,51,18
476090,Regency Beauty Institute-Hoover,53,53,53,0
449162,Regency Beauty Institute-Independence,73,73,73,0
467580,Regency Beauty Institute-Jacksonville Orange Park,37,37,37,0
467544,Regency Beauty Institute-Jacksonville Regency,41,41,41,0
450818,Regency Beauty Institute-Joliet,57,57,57,0
467553,Regency Beauty Institute-Knoxville,52,52,52,0
450784,Regency Beauty Institute-Lakewood,81,70,62,19
467571,Regency Beauty Institute-Lansing,80,71,65,15
476142,Regency Beauty Institute-Lewisville,29,29,29,0
467517,Regency Beauty Institute-Little Rock,86,77,71,15
447333,Regency Beauty Institute-Madison,49,49,49,0
467605,Regency Beauty Institute-Manassas,90,74,63,27
445221,Regency Beauty Institute-Maplewood,58,48,41,17
449205,Regency Beauty Institute-Mehlville,43,43,43,0
467641,Regency Beauty Institute-Merrillville,146,121,104,42
454476,Regency Beauty Institute-Mesa,61,47,37,24
458362,Regency Beauty Institute-Mesquite,77,77,77,0
450845,Regency Beauty Institute-Metro Center,32,25,21,11
454485,Regency Beauty Institute-Nashville,28,28,28,0
476133,Regency Beauty Institute-Newport News,138,138,138,0
467623,Regency Beauty Institute-North Nashville,70,62,57,13
454500,Regency Beauty Institute-North Olmsted,96,79,67,29
458177,Regency Beauty Institute-North Tucson,86,71,61,25
449241,Regency Beauty Institute-Olathe,63,48,38,25
454333,Regency Beauty Institute-Pasadena,85,69,59,26
449180,Regency Beauty Institute-Peoria,78,65,57,21
476160,Regency Beauty Institute-Plano,46,46,46,0
447342,Regency Beauty Institute-Ridgedale,52,41,34,18
467650,Regency Beauty Institute-Roanoke,58,50,44,14
450827,Regency Beauty Institute-Rockford,113,96,84,29
467632,Regency Beauty Institute-Round Rock,119,94,77,42
476106,Regency Beauty Institute-San Antonio,29,29,29,0
458317,Regency Beauty Institute-Shreveport,107,107,107,0
456737,Regency Beauty Institute-South Bend,102,102,102,0
458344,Regency Beauty Institute-Spartanburg,50,42,37,13
458326,Regency Beauty Institute-Springfield,72,64,58,14
174765,Regency Beauty Institute-St Cloud,76,76,76,0
449171,Regency Beauty Institute-St Peters,111,87,72,39
467678,Regency Beauty Institute-SW Houston,89,89,89,0
456719,Regency Beauty Institute-Tinley Park,85,85,85,0
467669,Regency Beauty Institute-Toledo,83,83,83,0
454324,Regency Beauty Institute-Tolleson,70,60,53,17
450881,Regency Beauty Institute-Topeka,57,57,57,0
450863,Regency Beauty Institute-Tri-County,46,46,46,0
450793,Regency Beauty Institute-Westminster,114,93,80,34
458308,Regency Beauty Institute-Wichita,15,15,15,0
383251,Regency Beauty Institute-Winston-Salem,97,97,97,0
446491,Regency School of Hair Design,17,15,13,4
231651,Regent University,5693,3748,2530,3163
470223,Regina's College of Beauty,23,21,20,3
460002,Regina's College of Beauty-Charlotte,102,71,51,51
458399,Regina's College of Beauty-High Point,59,53,49,10
199014,Regina's College of Beauty-Monroe,43,34,28,15
181792,Regional West Medical Center School of Radiologic Technology,8,8,8,0
167598,Regis College,2069,1550,1225,844
127918,Regis University,9722,6988,5251,4471
101994,Reid State Technical College,517,346,260,257
140872,Reinhardt University,1309,1258,1225,84
475033,Relay Graduate School of Education,721,275,0,721
457183,Remington College of Nursing Orlando,100,100,100,0
440271,Remington College-Baton Rouge Campus,300,300,300,0
375416,Remington College-Cleveland Campus,438,438,438,0
444121,Remington College-Cleveland West Campus,73,73,73,0
381741,Remington College-Colorado Springs Campus,7,7,7,0
457174,Remington College-Columbia Campus,336,336,336,0
223463,Remington College-Dallas Campus,904,904,904,0
377111,Remington College-Fort Worth Campus,408,408,408,0
460783,Remington College-Heathrow Campus,235,235,235,0
372958,Remington College-Honolulu Campus,495,495,495,0
380094,Remington College-Houston Campus,354,354,354,0
451857,Remington College-Houston Southeast Campus,252,252,252,0
160524,Remington College-Lafayette Campus,326,326,326,0
438869,Remington College-Little Rock Campus,229,229,229,0
412599,Remington College-Memphis Campus,814,814,814,0
366535,Remington College-Mobile Campus,472,472,472,0
445249,Remington College-Nashville Campus,298,298,298,0
445203,Remington College-North Houston Campus,474,474,474,0
451866,Remington College-Shreveport Campus,318,318,318,0
135939,Remington College-Tampa Campus,189,189,189,0
458104,Renaissance Academie,70,49,36,34
148256,Rend Lake College,2714,1894,1479,1235
391333,Rensselaer BOCES-Practical Nursing Program,34,34,34,0
129428,Rensselaer Hartford Graduate Center Inc,281,114,11,270
194824,Rensselaer Polytechnic Institute,6714,6622,6565,149
236382,Renton Technical College,3338,1945,1241,2097
178989,Research College of Nursing,408,330,281,127
149763,Resurrection University,462,373,316,146
476726,RGV Careers,223,223,223,0
217420,Rhode Island College,8700,6930,5802,2898
217493,Rhode Island School of Design,2420,2420,2420,0
221351,Rhodes College,2040,2032,2027,13
227757,Rice University,6628,6461,6356,272
107743,Rich Mountain Community College,957,594,411,546
233338,Richard Bland College of the College of William and Mary,1428,1074,895,533
227766,Richland College,19287,9540,4613,14674
148292,Richland Community College,3340,1826,1061,2279
199449,Richmond Community College,2664,1633,1112,1552
437769,Richmond School of Health and Technology,172,172,172,0
441104,Richmont Graduate University,279,223,188,91
186283,Rider University,5410,4621,4122,1288
136765,Ridge Career Center,717,587,522,195
175236,Ridgewater College,3766,2788,2293,1473
194879,Ridley-Lowell Business & Technical Institute-Binghamton,193,167,150,43
460695,Ridley-Lowell Business & Technical Institute-Danbury,49,48,48,1
129969,Ridley-Lowell Business & Technical Institute-New London,295,295,295,0
438267,Ridley-Lowell Business & Technical Institute-Poughkeepsie,376,376,376,0
136774,Ringling College of Art and Design,1253,1228,1212,41
475185,Rio Grande Bible Institute,108,101,97,11
121886,Rio Hondo College,16548,8471,4389,12159
105668,Rio Salado College,21472,9238,3054,18418
239628,Ripon College,904,894,888,16
436304,River Parishes Community College,3146,1623,853,2293
183114,River Valley Community College,987,490,239,748
173063,Riverland Community College,3308,1997,1334,1974
121901,Riverside City College,18165,9329,4863,13302
481191,Riverside County Office of Education,386,386,386,0
233408,Riverside School of Health Careers,305,297,291,14
419235,Rivertown School of Beauty Barber Skin Care and Nails,207,207,207,0
183211,Rivier University,2346,1556,1055,1291
185466,Rizzieri Aveda School for Beauty and Wellness,303,241,201,102
481447,Rizzieri Institute,53,37,27,26
221397,Roane State Community College,6214,3770,2535,3679
364575,Roane-Jackson Technical Center,39,39,39,0
233426,Roanoke College,2029,1990,1964,65
199467,Roanoke-Chowan Community College,933,594,422,511
165750,Rob Roy Academy-Fall River,105,105,105,0
167039,Rob Roy Academy-New Bedford,27,27,27,0
168032,Rob Roy Academy-Taunton,37,37,37,0
373696,Rob Roy Academy-Worcester,176,176,176,0
383279,Robert Fiance Beauty Schools-North Plainfield,185,127,89,96
186274,Robert Fiance Beauty Schools-Perth Amboy,193,147,116,77
185767,Robert Fiance Beauty Schools-West New York,259,186,138,121
136826,Robert Morgan Educational Center,816,654,572,244
215655,Robert Morris University,5481,4532,3935,1546
148335,Robert Morris University Illinois,3233,2888,2672,561
163754,Robert Paul Academy of Cosmetology Arts & Sciences,29,23,19,10
105677,Roberto-Venn School of Luthiery,39,39,39,0
194958,Roberts Wesleyan College,1735,1643,1585,150
199476,Robeson Community College,2260,1341,876,1384
170967,Rochester College,1129,882,723,406
174738,Rochester Community and Technical College,6057,3846,2728,3329
417901,Rochester General Hospital School of Medical Technology,24,24,24,0
195003,Rochester Institute of Technology,16583,15080,14119,2464
461546,Rochester School of Hair Design,35,30,27,8
148380,Rock Valley College,8150,5162,3652,4498
195049,Rockefeller University,201,201,201,0
148405,Rockford University,1230,1013,876,354
179043,Rockhurst University,2920,2340,1970,950
199485,Rockingham Community College,1854,1192,857,997
195058,Rockland Community College,7652,5543,4477,3175
418083,Rockland County BOCES-Practical Nursing Program,126,97,83,43
180595,Rocky Mountain College,1067,1041,1024,43
127945,Rocky Mountain College of Art and Design,775,645,562,213
475495,Rocky Mountain University of Health Professions,461,459,458,3
480790,Rocky Vista University,624,624,624,0
217518,Roger Williams University,4732,4311,4041,691
409616,Roger Williams University School of Law,420,420,420,0
152309,Rogers Academy of Hair Design,51,50,49,2
207661,Rogers State University,4473,3356,2600,1873
243416,Rogies School of Beauty Culture,33,33,33,0
209940,Rogue Community College,5530,3446,2392,3138
262466,Rolf Institute of Structural Integration,72,29,0,72
179052,Rolla Technical Institute,167,167,167,0
136950,Rollins College,3153,2807,2589,564
186335,Roman Academy of Beauty Culture,61,54,49,12
148487,Roosevelt University,6130,4720,3832,2298
145558,Rosalind Franklin University of Medicine and Science,2157,2056,1993,164
207670,Rose State College,7193,4200,2688,4505
152318,Rose-Hulman Institute of Technology,2302,2273,2255,47
209986,Roseburg Beauty College,40,40,40,0
439899,Rosedale Bible College,45,42,40,5
215682,Rosedale Technical Institute,684,684,684,0
369446,Rosel School of Cosmetology,80,55,38,42
445735,Roseman University of Health Sciences,1343,1315,1297,46
121992,Rosemead Beauty School,210,189,175,35
215691,Rosemont College,957,692,526,431
452081,Ross College-Sylvania,423,423,423,0
261685,Ross Medical Education Center-Ann Arbor,128,128,128,0
480550,Ross Medical Education Center-Bowling Green,128,128,128,0
261676,Ross Medical Education Center-Brighton,127,127,127,0
460127,Ross Medical Education Center-Canton,131,131,131,0
481906,Ross Medical Education Center-Charleston,66,66,66,0
203234,Ross Medical Education Center-Cincinnati,126,126,126,0
460093,Ross Medical Education Center-Davison,181,181,181,0
480523,Ross Medical Education Center-Dayton,94,94,94,0
481890,Ross Medical Education Center-Erlanger,25,25,25,0
172015,Ross Medical Education Center-Flint,307,307,307,0
456506,Ross Medical Education Center-Fort Wayne,138,138,138,0
460109,Ross Medical Education Center-Granger,174,174,174,0
365833,Ross Medical Education Center-Kentwood,176,176,176,0
481863,Ross Medical Education Center-Kokomo,115,115,115,0
171988,Ross Medical Education Center-Lansing,151,151,151,0
171997,Ross Medical Education Center-Madison Heights,270,270,270,0
476230,Ross Medical Education Center-Morgantown,84,84,84,0
452072,Ross Medical Education Center-New Baltimore,116,116,116,0
460118,Ross Medical Education Center-Niles,151,151,151,0
480532,Ross Medical Education Center-Ontario,136,136,136,0
363013,Ross Medical Education Center-Port Huron,62,62,62,0
456515,Ross Medical Education Center-Portage,136,136,136,0
365824,Ross Medical Education Center-Roosevelt Park,186,186,186,0
247409,Ross Medical Education Center-Saginaw,208,208,208,0
367158,Ross Medical Education Center-Taylor,80,80,80,0
446516,Rosslyn Training Academy of Cosmetology,31,31,31,0
184782,Rowan University,13349,11597,10499,2850
199494,Rowan-Cabarrus Community College,6731,3994,2610,4121
213932,Roxborough Memorial Hospital School of Nursing,124,124,124,0
167631,Roxbury Community College,2437,1345,793,1644
382267,Royale College of Beauty,54,53,53,1
437857,Rudae's School of Beauty Culture-Ft Wayne,138,122,112,26
152327,Rudae's School of Beauty Culture-Kokomo,39,39,39,0
441876,Rudy & Kelly Academy of Hair and Nails,228,191,167,61
148511,Rush University,2280,1763,1442,838
176318,Rust College,922,881,854,68
186371,Rutgers University-Camden,6264,5333,4746,1518
186380,Rutgers University-New Brunswick,48036,43201,40321,7715
186399,Rutgers University-Newark,11212,8938,7559,3653
455752,RWM Fiber Optics,73,73,73,0
243407,Ryder Memorial School for Practical Nursing,14,14,14,0
449506,SABER College,544,544,544,0
122180,Sacramento City College,23509,11974,6144,17365
172033,Sacred Heart Major Seminary,436,249,130,306
239637,Sacred Heart School of Theology,113,102,96,17
130253,Sacred Heart University,6983,5482,4542,2441
122205,Saddleback College,20871,11215,6334,14537
476948,SAE Institute of Technology-Atlanta,218,213,210,8
476911,SAE Institute of Technology-Los Angeles,225,176,143,82
476966,SAE Institute of Technology-Miami,233,233,233,0
446525,SAE Institute of Technology-Nashville,92,92,92,0
459462,SAE Institute of Technology-New York,218,176,149,69
410520,Sage College,447,288,183,264
459499,Sage School of Massage,28,28,28,0
441070,Saginaw Chippewa Tribal College,117,78,59,58
172051,Saginaw Valley State University,10240,8810,7899,2341
154235,Saint Ambrose University,3607,3131,2832,775
183239,Saint Anselm College,1923,1896,1878,45
149028,Saint Anthony College of Nursing,291,205,151,140
148876,Saint Augustine College,1607,1325,1143,464
199582,Saint Augustine's University,1299,1278,1265,34
157632,Saint Catharine College,767,650,575,192
216047,Saint Charles Borromeo Seminary-Overbrook,238,184,150,88
174783,Saint Cloud State University,16765,12953,10447,6318
227845,Saint Edward's University,4861,4120,3651,1210
195687,Saint Elizabeth College of Nursing,159,107,72,87
195702,Saint Elizabeth Medical Center School of Radiography,13,13,13,0
152497,Saint Elizabeth School of Nursing,269,235,212,57
148575,Saint Francis Medical Center College of Nursing,701,471,327,374
186423,Saint Francis Medical Center School of Nursing,56,56,56,0
215743,Saint Francis University,2344,1998,1781,563
207689,Saint Gregory's University,684,500,382,302
195720,Saint John Fisher College,3987,3596,3350,637
137272,Saint John Vianney College Seminary,94,94,94,0
167677,Saint John's Seminary,192,146,117,75
137281,Saint Johns River State College,6127,3840,2292,3835
174792,Saint Johns University,1979,1933,1904,75
160409,Saint Joseph Seminary College,133,131,129,4
161518,Saint Joseph's College of Maine,1614,1174,896,718
195544,Saint Joseph's College-New York,5354,4341,3699,1655
215770,Saint Joseph's University,8954,6597,5124,3830
152363,Saint Josephs College,1163,1088,1039,124
137032,Saint Leo University,16275,13817,12228,4047
179256,Saint Louis Christian College,245,200,171,74
179308,Saint Louis Community College,24005,14681,9968,14037
179159,Saint Louis University,17343,13185,10521,6822
179450,Saint Luke's College of Health Sciences,436,407,388,48
236452,Saint Martin's University,1787,1423,1193,594
152390,Saint Mary's College,1479,1473,1469,10
123554,Saint Mary's College of California,4257,3786,3490,767
174817,Saint Mary's University of Minnesota,5528,4154,3294,2234
152381,Saint Mary-of-the-Woods College,887,680,548,339
152451,Saint Meinrad School of Theology,246,195,163,83
231059,Saint Michael's College,2378,2147,2004,374
239716,Saint Norbert College,2222,2158,2118,104
122250,Saint Patrick's Seminary and University,92,92,92,0
175041,Saint Paul College,6740,4083,2740,4000
179317,Saint Paul School of Theology,160,135,120,40
186432,Saint Peter's University,3194,2656,2316,878
215798,Saint Vincent College,1813,1715,1654,159
136701,Saint Vincent de Paul Regional Seminary,106,103,101,5
215813,Saint Vincent Seminary,56,50,47,9
195580,Saint Vladimirs Orthodox Theological Seminary,81,73,68,13
148627,Saint Xavier University,4252,3258,2635,1617
199607,Salem College,1187,977,845,342
179195,Salem College of Hairstyling,45,45,45,0
186469,Salem Community College,1240,899,726,514
237783,Salem International University,618,616,615,3
167729,Salem State University,9301,7394,6194,3107
155830,Salina Area Technical College,447,329,270,177
461971,Salinas Beauty College Inc,66,47,35,31
417646,Saline County Career Center,23,23,23,0
163851,Salisbury University,8643,8045,7665,978
180647,Salish Kootenai College,840,753,696,144
459532,Salon & Spa Institute,105,105,105,0
461476,Salon 496 Barber Academy,30,27,25,5
414054,Salon Academy,48,47,46,2
481340,Salon Professional Academy,69,69,69,0
121868,Salon Success Academy-Corona,129,128,128,1
456588,Salon Success Academy-Fontana,54,54,54,0
456597,Salon Success Academy-Redlands,93,93,93,0
115357,Salon Success Academy-San Bernardino,30,30,30,0
121859,Salon Success Academy-Upland,228,185,156,72
230746,Salt Lake Community College,32003,16506,8674,23329
466523,Salter College-Chicopee,70,60,54,16
167738,Salter College-West Boylston,699,597,530,169
460570,Salter School of Nursing and Allied Health,257,235,220,37
447494,Salter School-Fall River,298,245,210,88
460589,Salter School-New Bedford,317,262,226,91
214564,Salus University,1011,944,903,108
217536,Salve Regina University,2603,2220,1981,622
227881,Sam Houston State University,19210,16090,14132,5078
195289,Samaritan Hospital School of Nursing,163,76,18,145
102049,Samford University,4833,4543,4361,472
199625,Sampson Community College,1538,997,723,815
122296,Samuel Merritt University,1542,1314,1172,370
227924,San Antonio College,23004,11491,5672,17332
123527,San Bernardino Valley College,12329,7071,4413,7916
112084,San Diego Christian College,914,855,817,97
122339,San Diego City College,16310,8019,3828,12482
451015,San Diego College,278,278,278,0
457244,San Diego Culinary Institute,54,46,41,13
122375,San Diego Mesa College,24251,12399,6409,17842
122384,San Diego Miramar College,11891,5501,2271,9620
122409,San Diego State University,31899,28810,26859,5040
441186,San Diego State University-Imperial Valley Campus,883,663,517,366
122454,San Francisco Art Institute,680,645,622,58
122506,San Francisco Conservatory of Music,399,397,396,3
454777,San Francisco Institute of Esthetics and Cosmetology,204,174,154,50
122597,San Francisco State University,29905,26574,24422,5483
122603,San Francisco Theological Seminary,167,106,69,98
227979,San Jacinto Community College,28385,14615,7656,20729
122649,San Joaquin College of Law,194,101,44,150
122658,San Joaquin Delta College,17629,10610,7062,10567
122694,San Joaquin Valley College-Bakersfield,642,642,642,0
262457,San Joaquin Valley College-Fresno,686,686,686,0
422020,San Joaquin Valley College-Fresno Aviation,87,87,87,0
456852,San Joaquin Valley College-Hesperia,578,578,578,0
481775,San Joaquin Valley College-Lancaster,167,167,167,0
447351,San Joaquin Valley College-Modesto,318,318,318,0
442444,San Joaquin Valley College-Ontario,698,698,698,0
448372,San Joaquin Valley College-Rancho Cordova,144,144,144,0
481784,San Joaquin Valley College-San Diego,9,9,9,0
475176,San Joaquin Valley College-Temecula,393,393,393,0
122685,San Joaquin Valley College-Visalia,1616,1616,1616,0
122746,San Jose City College,9446,4787,2432,7014
122755,San Jose State University,31278,26967,24196,7082
430670,San Juan Bautista School of Medicine,295,295,295,0
188100,San Juan College,8938,4963,2954,5984
199634,Sandhills Community College,4158,2707,1973,2185
383330,Sandusky Career Center,95,80,72,23
200244,Sanford College of Nursing,136,110,94,42
219392,Sanford Medical Center,24,24,24,0
420495,Sanford-Brown College-Atlanta,360,357,355,5
475051,Sanford-Brown College-Austin,17,17,17,0
166276,Sanford-Brown College-Boston,71,57,47,24
391582,Sanford-Brown College-Collinsville,28,25,23,5
476203,Sanford-Brown College-Columbus,31,31,31,0
404514,Sanford-Brown College-Dallas,588,588,588,0
458609,Sanford-Brown College-Dearborn,107,97,91,16
129613,Sanford-Brown College-Farmington,62,54,48,14
179201,Sanford-Brown College-Fenton,216,205,198,18
458618,Sanford-Brown College-Grand Rapids,57,54,52,5
458636,Sanford-Brown College-Hillside,41,41,41,0
404499,Sanford-Brown College-Houston,756,745,738,18
445142,Sanford-Brown College-Houston North Loop,81,81,81,0
458627,Sanford-Brown College-Indianapolis,36,36,36,0
420501,Sanford-Brown College-Middleburg Heights,495,485,478,17
458654,Sanford-Brown College-Phoenix,291,289,288,3
469188,Sanford-Brown College-Portland,50,42,36,14
456311,Sanford-Brown College-San Antonio,274,269,266,8
469568,Sanford-Brown College-Skokie,105,105,105,0
409829,Sanford-Brown College-St Peters,81,79,78,3
458645,Sanford-Brown College-Tinley Park,45,45,45,0
234216,Sanford-Brown College-Tysons Corner,231,209,194,37
448789,Sanford-Brown College-West Allis,9,9,9,0
217244,Sanford-Brown Institute-Cranston,125,125,125,0
385008,Sanford-Brown Institute-Ft Lauderdale,477,470,465,12
364335,Sanford-Brown Institute-Garden City,915,915,915,0
187161,Sanford-Brown Institute-Iselin,735,735,735,0
404505,Sanford-Brown Institute-Jacksonville,360,339,325,35
196857,Sanford-Brown Institute-New York,1479,1439,1413,66
458663,Sanford-Brown Institute-Orlando,107,97,90,17
216782,Sanford-Brown Institute-Pittsburgh,438,320,243,195
379029,Sanford-Brown Institute-Tampa,317,317,317,0
250407,Sanford-Brown Institute-Trevose,161,158,156,5
364326,Sanford-Brown Institute-White Plains,371,371,371,0
376136,Sanford-Brown Institute-Wilkins Township,96,66,47,49
481535,Sanford-Burnham Medical Research Institute,32,32,32,0
461500,Santa Ana Beauty Academy,43,19,4,39
481128,Santa Ana Beauty College,114,52,11,103
121619,Santa Ana College,28598,11883,3435,25163
122834,Santa Barbara Business College-Bakersfield,543,543,543,0
122852,Santa Barbara Business College-Santa Maria,188,188,188,0
433420,Santa Barbara Business College-Ventura,349,349,349,0
122889,Santa Barbara City College,19331,12147,8516,10815
122931,Santa Clara University,8770,7816,7225,1545
137096,Santa Fe College,15113,9713,6059,9054
188137,Santa Fe Community College,6265,3282,1775,4490
188146,Santa Fe University of Art and Design,826,822,819,7
122977,Santa Monica College,29999,17193,10720,19279
123013,Santa Rosa Junior College,22094,11876,6712,15382
399212,Santiago Canyon College,10939,4960,1938,9001
195304,Sarah Lawrence College,1782,1732,1701,81
137120,Sarasota County Technical Institute,670,504,420,250
406149,Sarasota School of Massage Therapy,77,77,77,0
148672,Sauk Valley Community College,2220,1408,998,1222
140951,Savannah College of Art and Design,11093,9785,8950,2143
480301,Savannah Law School,84,68,58,26
140960,Savannah State University,4772,4441,4221,551
140942,Savannah Technical College,4784,2768,1749,3035
123095,Saybrook University,589,589,589,0
192156,SBI Campus-An Affiliate of Sanford-Brown,274,255,243,31
195322,Schenectady County Community College,6574,4032,2747,3827
404338,Schiller International University,159,159,159,0
131061,Schilling-Douglas School of Hair Design,146,115,95,51
461403,Scholars Cosmetology University,30,30,30,0
377218,School of Automotive Machinists,156,156,156,0
443845,School of Health,413,413,413,0
480727,School of Missionary Aviation Technology,66,66,66,0
392354,School of Professional Horticulture at the New York Botanical Garden,10,10,10,0
143048,School of the Art Institute of Chicago,3402,3222,3107,295
166984,School of the Museum of Fine Arts-Boston,651,597,563,88
197151,School of Visual Arts,4338,4098,3945,393
172200,Schoolcraft College,12385,7072,4386,7999
228042,Schreiner University,1136,1111,1095,41
406325,Schuyler Steuben Chemung Tioga Allegany BOCES,96,83,76,20
215886,Schuylkill Technology Center,86,85,84,2
407577,Scioto County Career Technical Center,321,294,281,40
201982,Scott College of Cosmetology,99,99,99,0
105747,Scottsdale Community College,10313,5561,3159,7154
123165,Scripps College,1009,1001,996,13
148724,Seabury-Western Theological Seminary,30,11,0,30
447519,Seacoast Career School-Manchester Campus,321,263,225,96
433970,Seacoast Career Schools-Sanford Campus,254,217,193,61
107831,Searcy Beauty College Inc,104,76,57,47
236513,Seattle Central College,7110,5365,4184,2926
236072,Seattle Community College-North Campus,6118,3805,2240,3878
236504,Seattle Community College-South Campus,4951,3186,1992,2959
439914,Seattle Institute of Oriental Medicine,50,50,50,0
236577,Seattle Pacific University,4270,3863,3609,661
236595,Seattle University,7422,6410,5780,1642
381529,Seattle Vocational Institute,249,224,211,38
369695,Sebring Career Schools-Houston,98,98,98,0
246406,Sebring Career Schools-Huntsville,31,31,31,0
368540,Seguin Beauty School-New Braunfels,38,38,38,0
228088,Seguin Beauty School-Seguin,48,48,48,0
102058,Selma University,611,530,478,133
386153,Seminar L'moros Bais Yaakov,257,188,143,114
243498,Seminario Evangelico de Puerto Rico,224,116,49,175
207740,Seminole State College,2020,1295,928,1092
137209,Seminole State College of Florida,18427,11543,6885,11542
232885,Sentara College of Health Sciences,360,313,283,77
418700,Serbias Technical College,275,275,275,0
475839,Sessions College for Professional Design,70,63,59,11
186584,Seton Hall University,9903,8201,7141,2762
215947,Seton Hill University,2357,1948,1685,672
221519,Sewanee-The University of the South,1701,1681,1669,32
155858,Seward County Community College and Area Technical School,1857,1170,823,1034
461935,Seymour Beauty Academy,28,27,26,2
195438,Sh'or Yoshuv Rabbinical College,248,248,248,0
215983,Sharon Regional Health System School of Nursing,35,35,35,0
481331,Sharp Edgez Barber Institute,56,51,48,8
391759,Sharps Academy of Hair Styling,73,30,2,71
123280,Shasta Bible College and Graduate School,53,40,32,21
123299,Shasta College,8479,5382,3817,4662
121637,Shasta School of Cosmetology,71,71,71,0
199643,Shaw University,2062,1948,1875,187
439932,Shawnee Beauty College,26,26,26,0
148821,Shawnee Community College,1834,1194,870,964
205443,Shawnee State University,4341,3964,3710,631
412535,Shawsheen Valley Regional Vocational Technical School,47,46,46,1
446543,Shear Academy,26,26,26,0
412544,Shear Ego International School of Hair Design,73,66,62,11
451167,Shear Excellence Hair Academy,103,92,84,19
480842,Shear Finesse Hairstyling Academy,23,22,21,2
475653,Shear Learning Academy of Cosmetology,21,21,21,0
102067,Shelton State Community College,5068,3341,2468,2600
233541,Shenandoah University,4003,3191,2683,1320
237792,Shepherd University,4221,3708,3371,850
481137,Shepherds College,59,59,59,0
461485,Shepherds Theological Seminary,76,49,33,43
240666,Sheridan College,4437,2447,1441,2996
137245,Sheridan Technical Center,1244,1244,1244,0
218751,Sherman College of Straight Chiropractic,286,286,286,0
230144,Sherman Kendall Academy-Midvale,56,56,56,0
230135,Sherman Kendall Academy-Salt Lake City,79,79,79,0
148849,Shimer College,97,86,79,18
216010,Shippensburg University of Pennsylvania,7548,6915,6535,1013
236610,Shoreline Community College,5937,4137,3227,2710
107840,Shorter College,330,289,262,68
140988,Shorter University,1629,1507,1428,201
448309,Shorter University-College of Adult & Professional Programs,1118,1118,1118,0
459170,SICE Paul Mitchell Partner School,73,57,46,27
155867,Sidneys Hair Dressing College,48,48,48,0
195474,Siena College,3207,3117,3059,148
172264,Siena Heights University,2684,1808,1246,1438
123341,Sierra College,18374,10786,6951,11423
123350,Sierra College of Beauty,181,164,152,29
182458,Sierra Nevada College,955,841,770,185
123396,Sierra Valley College of Court Reporting,137,137,137,0
165060,Signature Healthcare Brockton Hospital School of Nursing,323,249,201,122
179238,Sikeston Career and Technology Center,71,71,71,0
239743,Silver Lake College of the Holy Family,679,400,223,456
167783,Simmons College,4655,3223,2335,2320
461759,Simmons College of Kentucky,124,66,28,96
195492,Simmons Institute of Funeral Service Inc,22,21,20,2
154350,Simpson College,1773,1607,1500,273
123457,Simpson University,1255,1152,1088,167
205470,Sinclair Community College,19176,10938,6774,12402
219374,Sinte Gleska University,689,432,268,421
219240,Sioux Falls Seminary,143,88,54,89
219408,Sisseton Wahpeton College,194,165,151,43
231068,SIT Graduate Institute,443,283,184,259
200466,Sitting Bull College,279,228,194,85
236638,Skagit Valley College,4790,3316,2571,2219
195526,Skidmore College,2702,2668,2647,55
460932,Skin Institute,55,55,55,0
455372,Skin Institute,14,13,13,1
455381,Skin Science Institute,67,47,34,33
444857,Skinworks School of Advanced Skincare,56,56,56,0
123509,Skyline College,10067,5106,2598,7469
261931,Skyline College-Roanoke,195,195,195,0
216038,Slippery Rock University of Pennsylvania,8347,7772,7411,936
167835,Smith College,3033,2974,2937,96
102076,Snead State Community College,2295,1794,1541,754
230597,Snow College,4605,3536,2813,1792
110778,Sofia University,453,420,399,54
163921,Sojourner-Douglass College,1080,757,549,531
399911,Soka University of America,412,412,412,0
123563,Solano Community College,9583,5376,3249,6334
459356,SOLEX College,84,69,59,25
451219,SOLEX Medical Academy,17,12,8,9
445957,Soma Institute-The National School of Clinical Massage Therapy,268,106,0,268
157711,Somerset Community College,7504,4806,3442,4062
457943,Somerset County Technology Center,100,100,100,0
123572,Sonoma State University,9120,8468,8052,1068
481094,Sotheby's Institute of Art-NY,136,135,134,2
107974,South Arkansas Community College,1632,1024,717,915
123633,South Baylo University,647,647,647,0
441894,South Branch Career and Technical Center,5,5,5,0
218733,South Carolina State University,3463,3142,2945,518
417637,South Central Career Center,135,135,135,0
173911,South Central College,3410,2265,1687,1723
160913,South Central Louisiana Technical College-Young Memorial Campus,2410,1208,600,1810
123642,South Coast College,374,295,243,131
220552,South College,1116,1116,1116,0
198242,South College-Asheville,256,239,228,28
219347,South Dakota School of Mines and Technology,2640,2334,2136,504
219356,South Dakota State University,12525,10465,9146,3379
366003,South Florida Bible College and Theological Seminary,126,68,30,96
443252,South Florida Institute of Technology,756,756,756,0
137315,South Florida State College,2699,1668,970,1729
482699,South Georgia State College,2579,2160,1877,702
141006,South Georgia Technical College,1828,1262,976,852
216074,South Hills Beauty Academy Inc,92,55,31,61
216083,South Hills School of Business & Technology,665,630,607,58
160472,South Louisiana Beauty College,41,41,41,0
434061,South Louisiana Community College,4593,3027,2235,2358
105792,South Mountain Community College,4718,2539,1437,3281
197850,South Piedmont Community College,2776,1438,762,2014
228158,South Plains College,9559,6317,4678,4881
236656,South Puget Sound Community College,4938,3495,2765,2173
149365,South Suburban College,5212,3135,2085,3127
228185,South Texas Barber College Inc,42,40,39,3
409315,South Texas College,31232,18776,10349,20883
228194,South Texas College of Law,1197,1034,933,264
455974,South Texas Training Center,136,136,136,0
228200,South Texas Vo-Tech Institute,316,316,316,0
456922,South Texas Vocational Technical Institute-Brownsville,278,278,278,0
456931,South Texas Vocational Technical Institute-Corpus Christi,268,268,268,0
228219,South Texas Vocational Technical Institute-McAllen,351,351,351,0
460172,South Texas Vocational Technical Institute-San Antonio,170,170,170,0
468006,South University-Accelerated Graduate Programs,80,66,57,23
480073,South University-Austin,156,95,55,101
480082,South University-Cleveland,254,165,107,147
251312,South University-Columbia,1627,1176,888,739
481720,South University-High Point,249,149,85,164
101116,South University-Montgomery,682,457,313,369
468024,South University-Novi,503,276,132,371
139579,South University-Savannah,1510,1155,928,582
449898,South University-Tampa,983,591,343,640
224776,South University-The Art Institute of Dallas,1423,1220,1089,334
468015,South University-The Art Institute of Fort Worth,346,308,284,62
133465,South University-West Palm Beach,1109,731,488,621
459259,South University–Richmond,699,438,270,429
475121,South University–Savannah Online,11143,11141,11140,3
459268,South University–Virginia Beach,790,538,376,414
156338,Southcentral Kentucky Community and Technical College,4758,2756,1744,3014
107637,Southeast Arkansas College,1601,1102,850,751
181640,Southeast Community College Area,9751,6501,4858,4893
157739,Southeast Kentucky Community and Technical College,5221,3060,1968,3253
417734,Southeast Missouri Hospital College of Nursing and Health Sciences,222,125,61,161
179557,Southeast Missouri State University,11767,9685,8332,3435
248314,Southeast School of Cosmetology,6,5,5,1
219426,Southeast Technical Institute,2467,1946,1683,784
449807,Southeast Texas Career Institute,119,119,119,0
176336,Southeastern Baptist College,38,31,27,11
199759,Southeastern Baptist Theological Seminary,2604,1897,1454,1150
406051,Southeastern Beauty School-Columbus North Lumpkin,78,78,78,0
102261,Southeastern Bible College,161,142,130,31
428170,Southeastern College-Greenacres,1157,894,721,436
443270,Southeastern College-Jacksonville,205,174,153,52
154378,Southeastern Community College,3225,2153,1611,1614
199722,Southeastern Community College,1402,980,766,636
148937,Southeastern Illinois College,1930,1186,810,1120
443261,Southeastern Institute-Charleston,229,180,148,81
451352,Southeastern Institute-Charlotte,345,265,213,132
444866,Southeastern Institute-Columbia,177,137,111,66
160612,Southeastern Louisiana University,14934,12171,10360,4574
207847,Southeastern Oklahoma State University,3826,3191,2777,1049
439978,Southeastern School of Cosmetology,84,84,84,0
368911,Southeastern Technical College,1533,808,442,1091
167871,Southeastern Technical Institute,112,95,86,26
137564,Southeastern University,3434,2946,2634,800
221661,Southern Adventist University,3255,2821,2544,711
107983,Southern Arkansas University Main Campus,3404,2885,2561,843
107992,Southern Arkansas University Tech,1730,1015,653,1077
461856,Southern California Health Institute,272,272,272,0
123952,Southern California Institute of Architecture,493,484,478,15
399869,Southern California Institute of Technology,496,496,496,0
117575,Southern California Seminary,189,115,68,121
117672,Southern California University of Health Sciences,968,471,157,811
459222,Southern California University SOMA,116,111,108,8
226903,Southern Careers Institute-Austin,316,316,316,0
459967,Southern Careers Institute-Brownsville,313,313,313,0
405076,Southern Careers Institute-Corpus Christi,320,320,320,0
459985,Southern Careers Institute-Harlingen,331,331,331,0
408385,Southern Careers Institute-Pharr,358,358,358,0
430245,Southern Careers Institute-San Antonio,612,612,612,0
482015,Southern Careers Institute-San Antonio,279,279,279,0
221670,Southern College of Optometry,508,508,508,0
130493,Southern Connecticut State University,10804,8997,7892,2912
139986,Southern Crescent Technical College,5177,3161,2142,3035
149222,Southern Illinois University-Carbondale,17964,15802,14478,3486
149231,Southern Illinois University-Edwardsville,13850,11947,10759,3091
376668,Southern Institute of Cosmetology,30,22,16,14
161545,Southern Maine Community College,7157,4426,3045,4112
228246,Southern Methodist University,10929,9456,8541,2388
206862,Southern Nazarene University,2249,2180,2136,113
183026,Southern New Hampshire University,28389,19084,13179,15210
365198,Southern Oklahoma Technology Center,470,200,63,407
210146,Southern Oregon University,5992,4692,3833,2159
141097,Southern Polytechnic State University,6549,5220,4362,2187
207786,Southern School of Beauty Inc,30,30,30,0
205966,Southern State Community College,2431,1597,1175,1256
446552,Southern Technical College,1502,1502,1502,0
481322,Southern Texas Careers Academy,35,19,8,27
251260,Southern Union State Community College,4805,3480,2811,1994
160621,Southern University and A & M College,6777,6095,5641,1136
160630,Southern University at New Orleans,2292,1910,1655,637
160649,Southern University at Shreveport,3018,2422,2121,897
440916,Southern University Law Center,691,686,683,8
230603,Southern Utah University,7745,6335,5421,2324
231086,Southern Vermont College,480,464,453,27
233611,Southern Virginia University,662,646,636,26
217776,Southern Wesleyan University,1701,1683,1672,29
237817,Southern West Virginia Community and Technical College,2002,1520,1276,726
193122,Southern Westchester BOCES-Practical Nursing Program,180,96,53,127
457624,Southern Worcester County Regional Voc School District,28,28,28,0
233082,Southside Regional Medical Center Professional Schools,63,45,33,30
233639,Southside Virginia Community College,5784,3172,1852,3932
413644,Southwest Acupuncture College-Albuquerque,62,56,53,9
436261,Southwest Acupuncture College-Boulder,138,123,113,25
366605,Southwest Acupuncture College-Santa Fe,53,47,44,9
449816,Southwest Applied Technology Center,509,193,34,475
179326,Southwest Baptist University,3812,2888,2301,1511
420246,Southwest College of Naturopathic Medicine & Health Sciences,427,413,404,23
382911,Southwest Collegiate Institute for the Deaf,149,131,122,27
366553,Southwest Florida College,1263,1030,880,383
141158,Southwest Georgia Technical College,1546,813,443,1103
442879,Southwest Institute of Healing Arts,1108,1108,1108,0
228291,Southwest Institute of Technology,10,10,10,0
175078,Southwest Minnesota State University,6917,4218,2403,4514
176354,Southwest Mississippi Community College,2021,1852,1767,254
228282,Southwest School of Business and Technical Careers-San Antonio,230,230,230,0
440721,Southwest Skill Center-Campus of Estrella Mountain Community College,283,209,171,112
368364,Southwest Technology Center,104,84,74,30
221485,Southwest Tennessee Community College,10817,6775,4732,6085
228316,Southwest Texas Junior College,5410,3171,2039,3371
451556,Southwest University at El Paso,1296,1296,1296,0
402776,Southwest University of Visual Arts-Albuquerque,224,165,127,97
104188,Southwest University of Visual Arts-Tucson,221,166,131,90
233648,Southwest Virginia Community College,2630,1650,1154,1476
239910,Southwest Wisconsin Technical College,4144,1880,736,3408
228468,Southwestern Adventist University,808,713,651,157
228325,Southwestern Assemblies of God University,2012,1691,1488,524
228486,Southwestern Christian College,172,163,157,15
207856,Southwestern Christian University,847,697,600,247
188207,Southwestern College,161,113,84,77
123800,Southwestern College,19591,11674,7672,11919
155900,Southwestern College,1661,998,574,1087
154396,Southwestern Community College,1573,1019,739,834
199731,Southwestern Community College,2242,1375,937,1305
143215,Southwestern Illinois College,11332,7046,4879,6453
188216,Southwestern Indian Polytechnic Institute,530,486,464,66
123970,Southwestern Law School,1146,883,720,426
172307,Southwestern Michigan College,2802,1877,1410,1392
207865,Southwestern Oklahoma State University,4942,4292,3871,1071
210155,Southwestern Oregon Community College,2038,1400,1077,961
228343,Southwestern University,1535,1525,1519,16
160579,SOWELA Technical Community College,3225,2213,1702,1523
445638,Spa Tech Institute-Ipswich,43,33,26,17
445656,Spa Tech Institute-Plymouth,136,94,66,70
445647,Spa Tech Institute-Westboro,93,63,44,49
161527,Spa Tech Institute-Westbrook,245,214,194,51
157757,Spalding University,2367,1975,1726,641
195623,Spanish-American Institute,15,8,4,11
207254,Spartan College of Aeronautics and Technology,817,817,817,0
218830,Spartanburg Community College,5864,3821,2789,3075
218821,Spartanburg Methodist College,818,806,798,20
172325,Specs Howard School of Media Arts,597,237,0,597
141060,Spelman College,2129,2088,2061,68
433563,Spencerian College-Lexington,159,135,120,39
157766,Spencerian College-Louisville,533,468,426,107
148982,Spertus College,219,86,3,216
236692,Spokane Community College,6731,5170,4381,2350
236708,Spokane Falls Community College,8855,5964,4503,4352
148991,Spoon River College,1784,1073,713,1071
172334,Spring Arbor University,3962,3068,2498,1464
102234,Spring Hill College,1422,1292,1210,212
233657,Springfield Beauty Academy,79,58,45,34
167899,Springfield College,3255,3100,3004,251
210100,Springfield College of Beauty,69,69,69,0
475273,Springfield College-School of Human Services,1763,1461,1268,495
167905,Springfield Technical Community College,6792,4413,3210,3582
199698,St Andrews University,635,609,592,43
195155,St Bernard's School of Theology and Ministry,98,39,2,96
195164,St Bonaventure University,2244,2117,2037,207
175005,St Catherine University,5017,3942,3254,1763
262031,St Charles Community College,7396,4841,3549,3847
172291,St Clair County Community College,4324,2623,1763,2561
174756,St Cloud Technical and Community College,4946,3179,2286,2660
195173,St Francis College,2819,2613,2481,338
186405,St Francis Medical Center-School of Radiologic Technology,15,15,15,0
195793,St James Mercy Hospital School of Radiologic Science,35,35,35,0
245652,St John's College,419,410,404,15
163976,St John's College,490,488,486,4
148593,St John's College of Nursing,124,119,115,9
364122,St John's Hospital School of Clinical Lab Science,6,6,6,0
123855,St John's Seminary,108,101,97,11
195809,St John's University-New York,20729,16450,13719,7010
217572,St Joseph School of Nursing,122,122,122,0
183248,St Joseph School of Nursing,131,103,85,46
195191,St Joseph's College of Nursing at St Joseph's Hospital Health Center,302,210,150,152
441627,St Joseph's Medical Center School of Radiography,24,24,24,0
195216,St Lawrence University,2506,2447,2410,96
442426,St Louis College of Health Careers-Fenton,301,268,246,55
179511,St Louis College of Health Careers-St Louis,295,290,286,9
179265,St Louis College of Pharmacy,1350,1346,1343,7
419271,St Louis Hair Academy,12,9,7,5
154262,St Luke's College,184,157,139,45
216162,St Lukes Hospital School of Nursing,139,139,139,0
213622,St Margaret School of Nursing,184,142,115,69
163912,St Mary's College of Maryland,1858,1816,1789,69
228149,St Mary's University,3868,3505,3279,589
174844,St Olaf College,3125,3098,3081,44
189811,St Paul's School of Nursing-Queens,592,408,287,305
195784,St Paul's School of Nursing-Staten Island,747,632,557,190
137078,St Petersburg College,31820,18279,9118,22702
227854,St Philip's College,10238,4612,1769,8469
195243,St Thomas Aquinas College,1972,1567,1307,665
137476,St Thomas University,2315,2008,1817,498
130448,St Vincent's College,827,425,165,662
407151,Stage One-The Hair School,99,99,99,0
446561,Stanbridge College,963,963,963,0
207704,Standard Beauty College of Oklahoma,83,83,83,0
243744,Stanford University,18346,16643,15585,2761
199740,Stanly Community College,2885,1681,1072,1813
461041,Star Career Academy-Audubon,469,411,373,96
469647,Star Career Academy-Clifton,229,163,120,109
440086,Star Career Academy-Egg Harbor,318,273,244,74
193760,Star Career Academy-New York,820,690,605,215
440907,Star Career Academy-Newark,497,323,208,289
383899,Star Career Academy-Philadelphia,838,754,698,140
437529,Star Career Academy-Syosset,355,281,232,123
367398,Star Career Academy–Brick,267,199,154,113
382902,Star College of Cosmetology 2,90,90,90,0
428295,Star Truck Driving School-Bensenville,63,52,45,18
412650,Star Truck Driving School-Hickory Hills,83,76,72,11
205841,Stark State College,15450,8156,4469,10981
123916,Starr King School for Ministry,90,55,34,56
459444,Starting Points Inc,45,32,23,22
462053,State Career College,86,86,86,0
239877,State College of Beauty Culture Inc,55,51,49,6
135391,State College of Florida-Manatee-Sarasota,10533,6864,4381,6152
179539,State Fair Community College,5185,3564,2744,2441
196176,State University of New York at New Paltz,7578,6936,6538,1040
233666,Staunton School of Cosmetology,32,27,23,9
448600,Stautzenberger College-Brecksville,317,230,173,144
205887,Stautzenberger College-Maumee,790,545,383,407
456117,Stautzenberger Institute-Allen Park,106,81,64,42
475565,Stella and Charles Guttman Community College,493,484,480,13
430847,StenoTech Career Institute-Fairfield,11,10,10,1
450146,StenoTech Career Institute-Piscataway,80,78,77,3
137537,Stenotype Institute of Jacksonville Inc-Jacksonville,226,160,117,109
228431,Stephen F Austin State University,12772,11006,9895,2877
179548,Stephens College,854,744,673,181
231095,Sterling College,116,109,104,12
155937,Sterling College,690,632,595,95
137546,Stetson University,4044,3911,3828,216
178767,Stevens Institute of Business & Arts,172,143,124,48
186867,Stevens Institute of Technology,5784,4793,4180,1604
230630,Stevens-Henager College of Business-Provo,351,351,351,0
460899,Stevens-Henager College-Boise,422,422,422,0
446677,Stevens-Henager College-Logan,140,140,140,0
438151,Stevens-Henager College-Murray,2541,2541,2541,0
230621,Stevens-Henager College-Ogden,320,320,320,0
477950,Stevens-Henager College-St George,168,168,168,0
164173,Stevenson University,4404,3771,3368,1036
160597,Stevensons Academy of Hair Design,116,91,74,42
219453,Stewart School,142,142,142,0
102270,Stillman College,863,830,808,55
448619,Stone Academy-East Hartford,312,250,210,102
130509,Stone Academy-Hamden,422,355,311,111
413778,Stone Academy-Waterbury,212,212,212,0
366340,Stone Child College,404,272,206,198
167996,Stonehill College,2481,2467,2458,23
196097,Stony Brook University,24143,21573,20044,4099
434496,Strand College of Hair Design,58,58,58,0
460604,Stratford School of Aviation Maintenance Technicians,41,41,41,0
438498,Stratford University,2825,1600,810,2015
450377,Strayer University-Alabama,852,367,61,791
458885,Strayer University-Arkansas,207,94,22,185
450298,Strayer University-Delaware,347,149,22,325
131803,Strayer University-District of Columbia,1372,678,236,1136
449038,Strayer University-Florida,2973,1470,511,2462
458919,Strayer University-Georgia,5071,2353,623,4448
459994,Strayer University-Global Region,2796,1240,253,2543
477020,Strayer University-Illinois,222,102,26,196
475884,Strayer University-Indiana,142,66,18,124
453127,Strayer University-Kentucky,568,258,59,509
458937,Strayer University-Louisiana,182,86,24,158
430184,Strayer University-Maryland,3074,1501,497,2577
477011,Strayer University-Minnesota,135,64,18,117
458955,Strayer University-Mississippi,277,123,26,251
481580,Strayer University-Missouri,94,42,9,85
453215,Strayer University-New Jersey,788,376,112,676
453163,Strayer University-North Carolina,3802,1638,266,3536
456667,Strayer University-Ohio,950,417,76,874
443784,Strayer University-Pennsylvania,2329,1071,267,2062
458964,Strayer University-South Carolina,2051,961,269,1782
443766,Strayer University-Tennessee,1973,854,142,1831
458973,Strayer University-Texas,1322,632,191,1131
456630,Strayer University-Utah,103,54,22,81
233684,Strayer University-Virginia,7649,4138,1903,5746
456621,Strayer University-West Virginia,210,91,15,195
475875,Strayer University-Wisconsin,154,66,9,145
216223,Stroudsburg School of Cosmetology,44,39,35,9
455725,Studio Academy of Beauty,363,363,363,0
430564,Studio Jewelers,61,39,25,36
236744,Stylemaster College of Hair Design,102,102,102,0
428073,Styles and Profiles Beauty College,25,25,25,0
446570,Styletrends Barber and Hairstyling Academy,17,10,6,11
449603,Success Schools,130,123,119,11
231721,Suffolk Beauty Academy,48,24,8,40
366395,Suffolk County Community College,26711,18820,14831,11880
168005,Suffolk University,8675,7530,6815,1860
228501,Sul Ross State University,2842,1941,1378,1464
433466,Sullivan and Cogliano Training Center,943,892,859,84
157270,Sullivan College of Technology and Design,381,294,238,143
431877,Sullivan County BOCES-Practical Nursing Program,30,17,10,20
195988,Sullivan County Community College,1585,1209,1019,566
157793,Sullivan University,5017,3919,3214,1803
447953,SUM Bible College and Theological Seminary,367,343,327,40
175120,Summit Academy Opportunities Industrialization Center,252,247,244,8
181543,Summit Christian College,29,23,19,10
400080,Summit College,947,947,947,0
455789,Summit Salon & Beauty School,13,13,13,0
208512,Sumner College,263,261,260,3
218867,Sumter Beauty College,28,28,28,0
451644,Sunnyside Beauty Academy,8,8,8,0
362700,Sunstate Academy,355,341,331,24
372718,Sunstate Academy,224,199,183,41
196060,SUNY at Albany,17338,15493,14398,2940
196079,SUNY at Binghamton,16077,15014,14383,1694
196158,SUNY at Fredonia,5391,5243,5149,242
196219,SUNY at Purchase College,4353,4112,3949,404
189547,SUNY Broome Community College,5894,4763,4192,1702
196121,SUNY College at Brockport,8128,7263,6729,1399
196149,SUNY College at Cortland,7110,6749,6537,573
196167,SUNY College at Geneseo,5644,5526,5452,192
196237,SUNY College at Old Westbury,4367,3939,3657,710
196194,SUNY College at Oswego,8117,7615,7306,811
196246,SUNY College at Plattsburgh,6051,5691,5458,593
196200,SUNY College at Potsdam,4042,3903,3817,225
196033,SUNY College of Agriculture and Technology at Cobleskill,2453,2342,2267,186
196103,SUNY College of Environmental Science and Forestry,2229,2063,1966,263
196228,SUNY College of Optometry,343,341,340,3
196006,SUNY College of Technology at Alfred,3555,3356,3222,333
196015,SUNY College of Technology at Canton,3512,3170,2938,574
196024,SUNY College of Technology at Delhi,3308,2880,2590,718
196255,SUNY Downstate Medical Center,1865,1552,1367,498
196264,SUNY Empire State College,11823,7303,4309,7514
196112,SUNY Institute of Technology at Utica-Rome,2480,1947,1620,860
196291,SUNY Maritime College,1755,1667,1612,143
196185,SUNY Oneonta,6034,5895,5808,226
197294,SUNY Westchester Community College,13781,9702,7640,6141
441432,Superior Career Institute,93,93,93,0
199768,Surry Community College,3454,2249,1640,1814
441672,Susquehanna County Career and Technology Center,64,64,64,0
216278,Susquehanna University,2187,2152,2129,58
247603,Sussex County Community College,3235,2246,1746,1489
137713,Suwannee-Hamilton Technical Center,142,117,105,37
377281,SW School of Business and Technical Careers,68,68,68,0
377272,SW School of Business and Technical Careers-Cosmetology,59,59,59,0
216287,Swarthmore College,1534,1529,1526,8
196389,Swedish Institute a College of Health Sciences,848,779,733,115
233718,Sweet Briar College,710,696,687,23
233286,Sylvain Melloul International Hair Academy,80,80,80,0
417947,Syracuse City Schools Practical Nursing Program,26,26,26,0
196413,Syracuse University,21267,19930,19092,2175
155973,Tabor College,736,632,565,171
236753,Tacoma Community College,7146,5304,4373,2773
124113,Taft College,5444,2620,1193,4251
454689,Taft University System,785,745,720,65
102298,Talladega College,932,882,849,83
137759,Tallahassee Community College,13509,8757,6355,7154
137777,Talmudic College of Florida,44,44,44,0
186900,Talmudical Academy-New Jersey,68,68,68,0
196440,Talmudical Institute of Upstate New York,24,23,23,1
451404,Talmudical Seminary of Bobov,307,307,307,0
196431,Talmudical Seminary Oholei Torah,321,321,321,0
216311,Talmudical Yeshiva of Philadelphia,124,124,124,0
228529,Tarleton State University,13307,10244,8278,5029
228547,Tarrant County College District,50771,28617,17420,33351
461494,Taylor Andrews Academy of Hair Design-West Jordan,175,136,110,65
461926,Taylor Andrews Academy-St George,120,92,73,47
149310,Taylor Business Institute,257,257,257,0
449524,Taylor College,234,234,234,0
137856,Taylor Technical Institute,58,51,48,10
152530,Taylor University,2245,2053,1929,316
261719,Taylortown School of Beauty Inc,204,204,204,0
249566,TDDS Technical Institute,374,374,374,0
196468,Teachers College at Columbia University,5149,3925,3169,1980
196477,Technical Career Institutes,3020,2791,2640,380
217712,Technical College of the Lowcountry,2427,1301,732,1695
427991,Technical Education Center-Osceola,478,394,351,127
418384,Technical Institute of Cosmetology Arts and Sciences,48,48,48,0
444893,Technical Learning Centers Inc,290,290,290,0
481173,Technology Center,35,35,35,0
149329,Telshe Yeshiva-Chicago,77,77,77,0
228608,Temple College,5506,3058,1821,3685
216339,Temple University,37270,33685,31436,5834
417789,Tennessee Academy of Cosmetology-Shelby Drive,125,87,62,63
416670,Tennessee Academy of Cosmetology-Stage Road,135,87,56,79
448150,Tennessee Career Institute,121,121,121,0
219596,Tennessee College of Applied Technology-Athens,202,202,202,0
219921,Tennessee College of Applied Technology-Covington,203,144,114,89
221591,Tennessee College of Applied Technology-Crossville,297,258,239,58
221430,Tennessee College of Applied Technology-Crump,249,220,205,44
219994,Tennessee College of Applied Technology-Dickson,481,457,445,36
220127,Tennessee College of Applied Technology-Elizabethton,533,468,435,98
220251,Tennessee College of Applied Technology-Harriman,250,235,227,23
220279,Tennessee College of Applied Technology-Hartsville,558,331,216,342
220321,Tennessee College of Applied Technology-Hohenwald,363,327,309,54
220394,Tennessee College of Applied Technology-Jacksboro,246,231,223,23
221616,Tennessee College of Applied Technology-Jackson,425,425,425,0
221625,Tennessee College of Applied Technology-Knoxville,760,611,536,224
220640,Tennessee College of Applied Technology-Livingston,442,312,247,195
220756,Tennessee College of Applied Technology-McKenzie,168,167,166,2
221607,Tennessee College of Applied Technology-McMinnville,270,197,160,110
220853,Tennessee College of Applied Technology-Memphis,817,731,688,129
221050,Tennessee College of Applied Technology-Morristown,638,504,436,202
221102,Tennessee College of Applied Technology-Murfreesboro,335,292,270,65
248925,Tennessee College of Applied Technology-Nashville,1014,735,594,420
221236,Tennessee College of Applied Technology-Newbern,340,248,202,138
221582,Tennessee College of Applied Technology-Oneida-Huntsville,322,208,151,171
221281,Tennessee College of Applied Technology-Paris,272,255,246,26
221333,Tennessee College of Applied Technology-Pulaski,697,352,177,520
221388,Tennessee College of Applied Technology-Ripley,176,135,115,61
221494,Tennessee College of Applied Technology-Shelbyville,436,366,330,106
221634,Tennessee College of Applied Technology-Whiteville,184,177,174,10
221829,Tennessee School of Beauty of Knoxville Inc,173,173,173,0
221838,Tennessee State University,8883,7273,6269,2614
221847,Tennessee Technological University,11118,10137,9521,1597
221856,Tennessee Temple University,1010,745,576,434
221731,Tennessee Wesleyan College,1084,1027,991,93
206011,Terra State Community College,2923,1707,1092,1831
163736,TESST College of Technology-Baltimore,683,683,683,0
164058,TESST College of Technology-Beltsville,462,462,462,0
161776,TESST College of Technology-Towson,360,360,360,0
187000,Teterboro School of Aeronautics,157,157,157,0
228699,Texarkana College,4233,2525,1661,2572
226152,Texas A & M International University,7431,5466,4184,3247
223214,Texas A & M University Health Science Center,2417,2328,2277,140
483036,Texas A & M University-Central Texas,2404,1281,557,1847
228723,Texas A & M University-College Station,55697,51467,48780,6917
224554,Texas A & M University-Commerce,11591,8448,6549,5042
224147,Texas A & M University-Corpus Christi,10913,9032,7841,3072
228705,Texas A & M University-Kingsville,12229,9442,7665,4564
224545,Texas A & M University-Texarkana,1842,1326,1002,840
440989,Texas Barber Colleges and Hairstyling Schools,907,907,907,0
458061,Texas Beauty College,89,44,15,74
228866,Texas Chiropractic College Foundation Inc,239,232,227,12
228875,Texas Christian University,9925,9317,8936,989
228884,Texas College,971,947,931,40
377315,Texas College of Cosmetology-Abilene,82,82,82,0
419633,Texas College of Cosmetology-San Angelo,93,93,93,0
441487,Texas County Technical College,139,112,94,45
430704,Texas Health and Science University,88,80,75,13
448196,Texas Health School,178,164,155,23
228981,Texas Lutheran University,1341,1297,1268,73
439127,Texas School of Business-Friendswood,262,262,262,0
229036,Texas School of Business-North Campus,436,436,436,0
229063,Texas Southern University,8703,7616,6936,1767
229319,Texas State Technical College-Harlingen,5332,3332,2321,3011
408394,Texas State Technical College-Marshall,755,514,392,363
228680,Texas State Technical College-Waco,3988,3229,2846,1142
229328,Texas State Technical College-West Texas,1281,857,642,639
228459,Texas State University,35546,31070,28185,7361
229115,Texas Tech University,33111,30145,28287,4824
229337,Texas Tech University Health Sciences Center,4519,3904,3545,974
229151,Texas Vocational Schools Inc,55,55,55,0
229160,Texas Wesleyan University,2397,2096,1904,493
229179,Texas Woman's University,15058,10943,8428,6630
216296,Thaddeus Stevens College of Technology,883,878,875,8
368832,Thanh Le College School of Cosmetology,40,32,26,14
438674,The Academy of Hair Design Six,79,79,79,0
108348,The Academy of Radio and TV Broadcasting,44,44,44,0
459578,The Academy Waukesha,161,137,121,40
188669,The Ailey School,91,91,91,0
138813,The Art Institute of Atlanta,3078,2766,2564,514
451820,The Art Institute of Austin,1413,1205,1071,342
410502,The Art Institute of California-Argosy University Hollywood,1906,1451,1157,749
448576,The Art Institute of California-Argosy University Inland Empire,2307,1770,1422,885
432533,The Art Institute of California-Argosy University Los Angeles,1808,1469,1250,558
441973,The Art Institute of California-Argosy University Orange County,1761,1269,951,810
450094,The Art Institute of California-Argosy University Sacramento,1185,846,626,559
117113,The Art Institute of California-Argosy University San Diego,1869,1624,1466,403
117928,The Art Institute of California-Argosy University San Francisco,1317,1015,820,497
451848,The Art Institute of California-Argosy University-Silicon Valley,570,429,338,232
450085,The Art Institute of Charleston,643,596,565,78
197832,The Art Institute of Charlotte,1427,1057,817,610
200624,The Art Institute of Cincinnati,38,35,33,5
126702,The Art Institute of Colorado,1794,1400,1145,649
132338,The Art Institute of Fort Lauderdale,1924,1431,1112,812
222938,The Art Institute of Houston,2338,1938,1680,658
448345,The Art Institute of Indianapolis,862,656,523,339
182111,The Art Institute of Las Vegas,1097,922,808,289
451796,The Art Institute of Michigan,1003,817,697,306
365055,The Art Institute of New York City,1158,1014,920,238
446668,The Art Institute of Ohio-Cincinnati,834,679,578,256
210942,The Art Institute of Philadelphia,2494,1900,1516,978
428444,The Art Institute of Phoenix,1045,916,833,212
210960,The Art Institute of Pittsburgh,1544,1297,1137,407
451662,The Art Institute of Pittsburgh-Online Division,10906,4622,556,10350
208239,The Art Institute of Portland,1348,1088,920,428
452027,The Art Institute of Raleigh-Durham,781,618,513,268
450049,The Art Institute of Salt Lake City,466,402,360,106
458982,The Art Institute of San Antonio,1115,853,683,432
234492,The Art Institute of Seattle,1573,1231,1009,564
482398,The Art Institute of St Louis,415,361,326,89
449010,The Art Institute of Tennessee-Nashville,991,952,926,65
444927,The Art Institute of Tucson,426,353,305,121
458496,The Art Institute of Virginia Beach,663,581,528,135
440341,The Art Institute of Washington,1499,1266,1115,384
456010,The Art Institute of Washington-Dulles,244,208,185,59
470092,The Art Institute of Wisconsin,535,426,355,180
173887,The Art Institutes International-Minnesota,1161,992,883,278
452018,The Art Institutes International–Kansas City,495,416,365,130
210906,The Art Institutes of York-PA,462,378,323,139
459480,The Artisan College of Cosmetology,30,30,30,0
132408,The Baptist College of Florida,529,449,398,131
476708,The Barber School,101,78,63,38
444404,The Beauty Institute,70,53,42,28
164933,The Boston Conservatory,774,760,752,22
384209,The Bryman School of Arizona,594,594,594,0
143978,The Chicago School of Professional Psychology at Chicago,1636,1264,1034,602
455433,The Chicago School of Professional Psychology at Irvine,273,182,125,148
455664,The Chicago School of Professional Psychology at Los Angeles,2006,1206,712,1294
459745,The Chicago School of Professional Psychology at Washington DC,373,276,216,157
455682,The Chicago School of Professional Psychology at Westwood,267,151,79,188
201821,The Christ College of Nursing and Health Sciences,535,373,269,266
461157,The Collective School Of Music,50,50,50,0
437635,The College of Health Care Professions-Austin,223,223,223,0
480824,The College of Health Care Professions-Dallas,134,134,134,0
480833,The College of Health Care Professions-Fort Worth,208,208,208,0
449250,The College of Health Care Professions-San Antonio,272,272,272,0
447591,The College of Health Care Professions-Southwest Houston,229,229,229,0
142294,The College of Idaho,1122,1090,1070,52
187134,The College of New Jersey,7340,6910,6653,687
193645,The College of New Rochelle,3966,3291,2865,1101
195234,The College of Saint Rose,4542,3779,3303,1239
174899,The College of Saint Scholastica,4206,3657,3309,897
197285,The College of Westchester,1197,1046,948,249
206589,The College of Wooster,2116,2092,2077,39
162830,The Colorlab Academy of Hair,55,55,55,0
456542,The Commonwealth Medical College,364,364,364,0
434672,The Community College of Baltimore County,23981,13354,7983,15998
430485,The Creative Center,86,86,86,0
141015,The Creative Circus,135,121,111,24
212018,The Dickinson School of Law of the Pennsylvania State University,142,142,142,0
437653,The English Center,79,78,78,1
235167,The Evergreen State College,4398,4129,3955,443
191320,The General Theological Seminary,81,59,46,35
452009,The Hair Academy,45,45,45,0
457457,The Hair Academy Inc,44,28,18,26
459019,The Hair Design School-Charlotte,134,117,106,28
459028,The Hair Design School-Durham,65,58,53,12
459037,The Hair Design School-E Greensboro,151,124,107,44
459073,The Hair Design School-N Memphis,61,61,61,0
459000,The Hair Design School-S Memphis,117,103,93,24
459046,The Hair Design School-Winston-Salem,121,99,85,36
148177,The Illinois Institute of Art-Chicago,2322,1987,1770,552
428286,The Illinois Institute of Art-Schaumburg,1066,907,804,262
430999,The Institute for Health Education,98,98,98,0
450650,The Institute of Beauty and Wellness,225,140,84,141
191287,The International Culinary Center,475,346,261,214
146241,The John Marshall Law School,1466,1206,1046,420
192110,The Juilliard School,927,865,826,101
454184,The King’s College,516,502,493,23
459453,The Lab-Paul Mitchell Partner School,138,119,106,32
161208,The Landing School,83,83,83,0
117751,The Master's College and Seminary,1499,1257,1105,394
436632,The Medical Arts School,163,124,99,64
119544,The National Hispanic University,813,554,389,424
167057,The New England Conservatory of Music,813,774,749,64
167321,The New England Institute of Art,779,738,712,67
193654,The New School,10301,9145,8415,1886
456065,The Ohio Academy Paul Mitchell Partner School-Cleveland,181,151,131,50
456074,The Ohio Academy Paul Mitchell Partner School-Columbus,216,185,164,52
457475,The Process Institute of Cosmetology,93,93,93,0
215637,The Restaurant School at Walnut Hill College,427,427,427,0
186876,The Richard Stockton College of New Jersey,8458,7725,7272,1186
448804,The Robert B Miller College,328,170,67,261
195128,The Sage Colleges,2832,2229,1852,980
215530,The Salon Professional Academy-Altoona,29,27,26,3
457572,The Salon Professional Academy-Anderson,106,106,106,0
454537,The Salon Professional Academy-Appleton,61,61,61,0
460905,The Salon Professional Academy-Cincinnati,58,58,58,0
459295,The Salon Professional Academy-Colorado Springs,86,69,57,29
238810,The Salon Professional Academy-Eau Claire,77,69,63,14
461458,The Salon Professional Academy-Elgin,33,21,13,20
459392,The Salon Professional Academy-Evansville,105,105,105,0
448026,The Salon Professional Academy-Fargo,90,86,84,6
459347,The Salon Professional Academy-Ft Myers,36,29,25,11
457439,The Salon Professional Academy-Gainesville,37,29,24,13
126164,The Salon Professional Academy-Grand Junction,90,90,90,0
457749,The Salon Professional Academy-Great Falls,102,92,86,16
480976,The Salon Professional Academy-Huntsville,48,48,48,0
461731,The Salon Professional Academy-Iowa City,39,37,36,3
461908,The Salon Professional Academy-Kenosha,113,89,73,40
462017,The Salon Professional Academy-Kokomo,68,68,68,0
458098,The Salon Professional Academy-Lewisville,80,80,80,0
156967,The Salon Professional Academy-Lexington,132,132,132,0
385132,The Salon Professional Academy-Melbourne,99,93,89,10
460987,The Salon Professional Academy-North Little Rock,64,59,55,9
458168,The Salon Professional Academy-Onalaska,87,86,86,1
457916,The Salon Professional Academy-Perrysburg,76,59,48,28
462345,The Salon Professional Academy-Shorewood,162,147,137,25
483106,The Salon Professional Academy-South Plainfield,101,77,61,40
460996,The Salon Professional Academy-St Charles,100,90,84,16
459550,The Salon Professional Academy-Tacoma,152,147,143,9
457420,The Salon Professional Academy-Tampa,99,70,51,48
457448,The Salon Professional Academy-The Villages,148,148,148,0
457837,The Salon Professional Academy-Tonawanda,109,76,55,54
250832,The Salon Professional Academy-Williston,64,64,64,0
451307,The Salon Spa Academy,61,53,47,14
442815,The Salter School-Malden Campus,345,293,259,86
391564,The Salter School-Tewksbury Campus,230,197,175,55
125037,The Santa Barbara and Ventura Colleges of Law-Ventura,107,41,0,107
475228,The Santa Barbara and Ventura Colleges of Law–Santa Barbara,107,41,0,107
142489,The School of Hairstyling,36,36,36,0
441131,The Seattle School of Theology & Psychology,284,147,62,222
157748,The Southern Baptist Theological Seminary,3226,2437,1944,1282
204769,The Spa School,61,61,61,0
455901,The Temple-A Paul Mitchell Partner School,216,216,216,0
100751,The University of Alabama,34752,31519,29498,5254
202763,The University of Findlay,4880,3759,3041,1839
180489,The University of Montana,14525,12126,10582,3943
180692,The University of Montana-Western,1455,1301,1196,259
137847,The University of Tampa,7260,6763,6450,810
221740,The University of Tennessee-Chattanooga,11674,10450,9676,1998
221759,The University of Tennessee-Knoxville,30030,27696,26283,3747
221768,The University of Tennessee-Martin,7423,6553,5988,1435
228769,The University of Texas at Arlington,33329,24794,19318,14011
228778,The University of Texas at Austin,52059,49432,47741,4318
227377,The University of Texas at Brownsville,12285,8511,6018,6267
228787,The University of Texas at Dallas,21193,17983,16006,5187
228796,The University of Texas at El Paso,23003,17692,14241,8762
229027,The University of Texas at San Antonio,28623,24539,21943,6680
228802,The University of Texas at Tyler,7476,5774,4711,2765
229300,The University of Texas Health Science Center at Houston,4615,3775,3291,1324
228644,The University of Texas Health Science Center at San Antonio,3148,2929,2802,346
416801,The University of Texas MD Anderson Cancer Center,317,297,283,34
228653,The University of Texas Medical Branch,3112,2630,2349,763
229018,The University of Texas of the Permian Basin,5131,3309,2124,3007
227368,The University of Texas-Pan American,20053,16449,14138,5915
215105,The University of the Arts,2063,2014,1983,80
233897,The University of Virginia's College at Wise,2291,1802,1471,820
138354,The University of West Florida,12588,9884,8183,4405
210711,The Vision Academy,59,59,59,0
126012,The Wright Institute,434,434,434,0
216348,Theological Seminary of the Reformed Episcopal Church,27,20,16,11
216357,Thiel College,1100,1076,1061,39
124292,Thomas Aquinas College,366,366,366,0
161563,Thomas College,1522,1104,835,687
187046,Thomas Edison State College,20877,8453,138,20739
126049,Thomas Jefferson School of Law,1036,770,606,430
216366,Thomas Jefferson University,3635,2934,2496,1139
172477,Thomas M Cooley Law School,2477,1220,443,2034
157809,Thomas More College,1600,1370,1221,379
183275,Thomas More College of Liberal Arts,80,80,80,0
233754,Thomas Nelson Community College,11033,6072,3565,7468
141167,Thomas University,1090,784,588,502
179645,Three Rivers Community College,4399,3177,2559,1840
129808,Three Rivers Community College,4749,2663,1609,3140
103778,Thunderbird School of Global Management,1022,720,534,488
372000,Thuy Princess Beauty College,77,70,65,12
233772,Tidewater Community College,28999,17375,11500,17499
232919,Tidewater Tech-Trades,310,280,260,50
206039,Tiffin Academy of Hair Design,42,42,42,0
206048,Tiffin University,4954,3346,2323,2631
420723,Tillamook Bay Community College,514,323,227,287
418968,Tint School of Makeup and Cosmetology-Dallas,69,69,69,0
469197,Tint School of Makeup and Cosmetology-Grand Prairie,140,140,140,0
227058,Tint School of Makeup and Cosmetology-Irving,108,95,86,22
141185,Toccoa Falls College,870,814,777,93
442781,Tohono O'Odham Community College,243,130,73,170
375540,Toledo Academy of Beauty Culture-East,111,69,42,69
204459,Toledo Public Schools Adult and Continuing Education,145,145,145,0
454078,Toledo Restaurant Training Center,40,40,40,0
137865,Tom P Haney Technical Center,421,397,385,36
476568,Tomorrow's Image Barber Academy of Virginia,18,18,18,0
196565,Tompkins Cortland Community College,5490,3562,2587,2903
457776,Toni & Guy Hairdressing Academy-Albuquerque,84,84,84,0
413945,Toni & Guy Hairdressing Academy-Atlanta,78,78,78,0
460066,Toni & Guy Hairdressing Academy-Bellingham,75,75,75,0
443942,Toni & Guy Hairdressing Academy-Boise,105,105,105,0
436775,Toni & Guy Hairdressing Academy-Carrollton,192,192,192,0
244491,Toni & Guy Hairdressing Academy-Coeur D Alene,112,112,112,0
443289,Toni & Guy Hairdressing Academy-Colorado Springs,49,49,49,0
455965,Toni & Guy Hairdressing Academy-Cranston,139,139,139,0
136783,Toni & Guy Hairdressing Academy-Jacksonville,32,32,32,0
481562,Toni & Guy Hairdressing Academy-Manteca,54,53,52,2
461227,Toni & Guy Hairdressing Academy-Modesto,47,45,43,4
116350,Toni & Guy Hairdressing Academy-Santa Monica,268,268,268,0
235352,Toni & Guy Hairdressing Academy-Shoreline,65,65,65,0
476629,Toni & Guy Hairdressing Academy-Toledo,116,116,116,0
434344,Toni & Guy Hairdressing Academy-Worcester,58,58,58,0
481100,Top Nails & Hair Beauty School,40,25,15,25
196583,Torah Temimah Talmudical Seminary,180,180,180,0
364584,Total Cosmetology Training Center,129,90,65,64
455187,Total Image Beauty Academy,136,95,68,68
447856,Total International Career Institute,103,103,103,0
444909,Total Look School of Cosmetology & Massage Therapy,5,5,5,0
176406,Tougaloo College,878,860,849,29
196592,Touro College,13868,10325,8105,5763
459736,Touro University California,1357,1246,1178,179
459824,Touro University Nevada,1248,1104,1015,233
459727,Touro University Worldwide,363,304,267,96
164076,Towson University,22499,19582,17786,4713
461397,Tramy Beauty School,270,191,139,131
457703,Transformed Barber and Cosmetology Academy,105,69,46,59
157818,Transylvania University,1082,1073,1067,15
141945,Travel Institute of the Pacific,188,188,188,0
135522,Traviss Career Center,446,366,325,121
245281,Traxlers School of Hair,31,31,31,0
210234,Treasure Valley Community College,2443,1625,1212,1231
443298,Trend Barber College,196,196,196,0
451316,Trend Setters School of Cosmetology,72,72,72,0
245069,Trend Setters' Academy of Beauty Culture-Elizabethtown,48,40,34,14
157827,Trend Setters' Academy of Beauty Culture-Louisville,95,70,54,41
468705,Trend Setters' Academy of Beauty Culture-Louisville,194,167,149,45
447865,Trendsetters School of Beauty & Barbering,36,31,28,8
482167,Trenz Beauty Academy,34,21,12,22
221892,Trevecca Nazarene University,2406,1967,1687,719
459408,Tri County Regional Vocational Technical High School,51,42,38,13
418287,Tri County Technology Center,539,258,116,423
206172,Tri-County Adult Career Center,129,129,129,0
149499,Tri-County Beauty Academy,14,14,14,0
199795,Tri-County Community College,1412,908,654,758
218885,Tri-County Technical College,6553,4645,3681,2872
206181,Tri-Rivers Career Center,158,135,124,34
206154,Tri-State Bible College,59,37,23,36
130581,Tri-State College of Acupuncture,112,98,90,22
402800,Tri-State Cosmetology Institute,144,121,106,38
476531,Tri-State Institute of Hair Design,39,35,32,7
448859,Triangle Tech Inc-Bethlehem,133,133,133,0
216454,Triangle Tech Inc-Dubois,184,184,184,0
216427,Triangle Tech Inc-Erie,74,74,74,0
216445,Triangle Tech Inc-Greensburg,171,171,171,0
216436,Triangle Tech Inc-Pittsburgh,251,251,251,0
443377,Triangle Tech Inc-Sunbury,105,105,105,0
460747,Tribeca Flashpoint Media Arts Academy,386,386,386,0
455895,Tricoci University of Beauty Culture-Bridgeview,165,130,107,58
454971,Tricoci University of Beauty Culture-Chicago,177,131,101,76
470393,Tricoci University of Beauty Culture-Chicago NE,84,72,64,20
454980,Tricoci University of Beauty Culture-Glendale Heights,133,103,83,50
150303,Tricoci University of Beauty Culture-Highland,182,148,126,56
414869,Tricoci University of Beauty Culture-Indianapolis,111,82,63,48
455886,Tricoci University of Beauty Culture-Libertyville,150,117,95,55
454999,Tricoci University of Beauty Culture-Peoria,114,97,85,29
455008,Tricoci University of Beauty Culture-Rockford,139,112,94,45
218894,Trident Technical College,17489,10868,7521,9968
450979,Trident University International,7093,6162,5560,1533
152567,Trine University,1875,1605,1430,445
414878,Trine University-Regional/Non-Traditional Campuses,541,426,353,188
128258,Trinidad State Junior College,1791,1199,900,891
137953,Trinity Baptist College,323,270,236,87
200484,Trinity Bible College,198,175,160,38
149505,Trinity Christian College,1380,1225,1125,255
130590,Trinity College,2390,2266,2188,202
137962,Trinity College of Florida,224,211,202,22
146755,Trinity College of Nursing & Health Sciences,234,161,114,120
431929,Trinity College of Puerto Rico,243,239,237,6
216463,Trinity Episcopal School for Ministry,154,106,76,78
204893,Trinity Health System School of Nursing,87,87,87,0
135610,Trinity International University-Florida,347,204,113,234
149514,Trinity International University-Illinois,2125,1576,1234,891
123448,Trinity Law School,216,170,142,74
235769,Trinity Lutheran College,194,187,182,12
206215,Trinity Lutheran Seminary,116,83,63,53
229267,Trinity University,2358,2297,2259,99
225308,Trinity Valley Community College,5172,3520,2685,2487
459161,Trinity Vocational Center,90,46,17,73
131876,Trinity Washington University,2506,1768,1301,1205
149532,Triton College,11225,6133,3559,7666
196653,Trocaire College,1492,996,675,817
102368,Troy University,20573,14338,10334,10239
182500,Truckee Meadows Community College,11204,5691,2905,8299
141237,Truett-McConnell College,1606,1050,691,915
179742,Truman Medical Center School of Nurse Anesthesia,44,44,44,0
178615,Truman State University,6225,5856,5612,613
206224,Trumbull Business College,240,195,166,74
407595,Trumbull Career & Technical Center,230,230,230,0
105987,Tucson College,284,284,284,0
447704,Tucson College of Beauty,64,59,56,8
168148,Tufts University,10872,10365,10051,821
160755,Tulane University of Louisiana,12938,11495,10572,2366
118125,Tulare Beauty College,36,20,10,26
207935,Tulsa Community College,18640,10488,6367,12273
261393,Tulsa Technology Center-Broken Arrow Campus,736,351,156,580
261375,Tulsa Technology Center-Lemley Campus,1762,832,362,1400
482264,Tulsa Technology Center-Owasso Campus,323,112,5,318
207607,Tulsa Technology Center-Peoria Campus,624,291,122,502
261384,Tulsa Technology Center-Riverside Campus,694,327,142,552
482273,Tulsa Technology Center-Sand Springs Campus,196,69,5,191
442329,Tulsa Welding School-Jacksonville,696,696,696,0
476063,Tulsa Welding School-Jacksonville,176,176,176,0
207962,Tulsa Welding School-Tulsa,1094,1094,1094,0
481669,Tulsa Welding School-Tulsa,125,125,125,0
130606,Tunxis Community College,4547,2648,1688,2859
444936,Turning Point Beauty College,49,49,49,0
200527,Turtle Mountain Community College,602,530,483,119
221953,Tusculum College,2055,1978,1928,127
102377,Tuskegee University,3118,3018,2954,164
172495,Twin City Beauty College,111,55,18,93
461634,Twin Rivers Adult School,51,38,31,20
229355,Tyler Junior College,11308,7915,6200,5108
375568,U S Grant Joint Vocational School,18,11,8,10
397942,UEI College-Fresno,1014,1014,1014,0
480897,UEI College-Santa Cruz,131,131,131,0
230676,Uintah Basin Applied Technology College,1238,588,260,978
481182,Ukiah Adult School,59,59,59,0
418056,Ulster County BOCES-Practical Nursing Program,127,104,93,34
196699,Ulster County Community College,3615,2312,1654,1961
441371,Ultimate Medical Academy-Clearwater,359,358,357,2
450173,Ultimate Medical Academy-Tampa,11170,11145,11129,41
481252,Ultrasound Medical Institute,8,8,8,0
210270,Umpqua Community College,2183,1451,1081,1102
246789,Unification Theological Seminary,114,98,88,26
196866,Union College,2246,2233,2225,21
181738,Union College,911,845,803,108
157863,Union College,1164,976,858,306
187198,Union County College,11969,7813,5713,6256
417831,Union County Vocational Technical School,137,137,137,0
446932,Union Graduate College,410,228,115,295
206279,Union Institute & University,1660,1283,1041,619
233842,Union Presbyterian Seminary,205,148,112,93
196884,Union Theological Seminary in the City of New York,253,230,216,37
221971,Union University,3993,3415,3047,946
469911,Unitech Training Academy-Alexandria,78,78,78,0
448646,Unitech Training Academy-Houma,70,70,70,0
444945,Unitech Training Academy-Lafayette,129,129,129,0
469920,Unitech Training Academy-Lake Charles,92,92,92,0
447467,Unitech Training Academy-West Monroe,111,111,111,0
461810,United Beauty College,59,45,36,23
124681,United Education Institute-Huntington Park Campus,2732,2732,2732,0
481492,United Medical and Business Institute,22,22,22,0
128328,United States Air Force Academy,3993,3993,3993,0
130624,United States Coast Guard Academy,902,902,902,0
197027,United States Merchant Marine Academy,985,968,958,27
197036,United States Military Academy,4591,4591,4591,0
164155,United States Naval Academy,4526,4526,4526,0
102395,United States Sports Academy,347,188,89,258
447050,United States University,282,198,145,137
197018,United Talmudical Seminary,2071,2071,2071,0
419031,United Technical Center,22,22,22,0
206288,United Theological Seminary,640,565,519,121
175139,United Theological Seminary of the Twin Cities,128,79,49,79
200554,United Tribes Technical College,505,466,441,64
459204,Unitek College,904,904,904,0
161572,Unity College,553,549,547,6
459365,Unity Cosmetology College,77,58,46,31
153542,UnityPoint Health-Des Moines School of Radiologic Technology,17,17,17,0
446589,Universal Career School,133,108,92,41
124779,Universal College of Beauty Inc-Los Angeles 1,33,31,29,4
372240,Universal College of Beauty Inc-Los Angeles 2,32,32,32,0
446598,Universal College of Healing Arts,28,28,28,0
459374,Universal Spa Training Academy,58,48,42,16
460543,Universal Technical Institute - Dallas Fort Worth,1006,1006,1006,0
106041,Universal Technical Institute of Arizona Inc,2337,2337,2337,0
105215,Universal Technical Institute of Arizona Inc-Motorcycle Mechanics Institute Division,2049,2049,2049,0
438504,Universal Technical Institute of California Inc,2466,2466,2466,0
366191,Universal Technical Institute of Illinois Inc,1343,1343,1343,0
447403,Universal Technical Institute of Massachusetts Inc,1083,1083,1083,0
448433,Universal Technical Institute of Northern California Inc,1916,1916,1916,0
445799,Universal Technical Institute of Pennsylvania Inc,1728,1728,1728,0
229416,Universal Technical Institute of Texas Inc.,2097,2097,2097,0
369400,Universal Technical Institute-Auto Motorcycle & Marine Mechanics Institute Division-Orlando,3208,3208,3208,0
376385,Universal Technology College of Puerto Rico,1260,1218,1191,69
439996,Universal Therapeutic Massage Institute,90,90,90,0
481429,Universal Training Institute,165,165,165,0
241191,Universidad Adventista de las Antillas,1403,1329,1282,121
243568,Universidad Central Del Caribe,467,440,422,45
243346,Universidad Del Este,13420,11143,9681,3739
243443,Universidad del Sagrado Corazon,5892,5000,4435,1457
243601,Universidad Del Turabo,17287,14142,12133,5154
475811,Universidad Internacional Iberoamericana,104,104,104,0
241739,Universidad Metropolitana,13631,11537,10202,3429
441690,Universidad Pentecostal Mizpa,412,259,160,252
243577,Universidad Politecnica de Puerto Rico,4646,3276,2394,2252
241614,Universidad Teologica del Caribe,202,146,110,92
476805,University Academy of Hair Design,65,65,65,0
196088,University at Buffalo,29850,26710,24816,5034
363934,University of Advancing Technology,1017,1015,1014,3
454953,University of Aesthetics-Chicago,33,25,19,14
454962,University of Aesthetics-Downers Grove,31,27,25,6
200800,University of Akron Main Campus,24932,20917,18340,6592
200846,University of Akron Wayne College,2020,1266,885,1135
100663,University of Alabama at Birmingham,18568,14482,11961,6607
100706,University of Alabama in Huntsville,7376,5794,4802,2574
102553,University of Alaska Anchorage,17363,11689,7904,9459
102614,University of Alaska Fairbanks,9166,6231,4283,4883
102632,University of Alaska Southeast,2996,1727,889,2107
442930,University of Antelope Valley,804,804,804,0
104179,University of Arizona,40621,37418,35388,5233
106397,University of Arkansas,25341,22276,20379,4962
106245,University of Arkansas at Little Rock,12377,8895,6632,5745
106485,University of Arkansas at Monticello,3893,3085,2546,1347
106412,University of Arkansas at Pine Bluff,2615,2441,2328,287
106999,University of Arkansas Community College-Batesville,1353,975,784,569
107725,University of Arkansas Community College-Hope,1460,976,732,728
107585,University of Arkansas Community College-Morrilton,2149,1565,1270,879
106263,University of Arkansas for Medical Sciences,2867,2361,2059,808
108092,University of Arkansas-Fort Smith,7170,5945,5116,2054
161873,University of Baltimore,6518,4625,3457,3061
128744,University of Bridgeport,4842,3811,3159,1683
110635,University of California-Berkeley,36198,35256,34675,1523
110644,University of California-Davis,33307,32493,31986,1321
110398,University of California-Hastings College of Law,1088,1078,1072,16
110653,University of California-Irvine,28895,28370,28046,849
110662,University of California-Los Angeles,40795,40181,39794,1001
445188,University of California-Merced,6195,6157,6132,63
110671,University of California-Riverside,21207,20871,20653,554
110680,University of California-San Diego,29517,28963,28606,911
110699,University of California-San Francisco,3079,3079,3079,0
110705,University of California-Santa Barbara,22225,21947,21771,454
110714,University of California-Santa Cruz,17203,16933,16755,448
106704,University of Central Arkansas,11534,10007,9045,2489
132903,University of Central Florida,59589,47696,39966,19623
176965,University of Central Missouri,12513,10471,9203,3310
206941,University of Central Oklahoma,17220,13839,11644,5576
237312,University of Charleston,1935,1846,1788,147
144050,University of Chicago,15048,13689,12848,2200
201955,University of Cincinnati-Blue Ash College,4816,3712,2967,1849
201946,University of Cincinnati-Clermont College,3461,2644,2091,1370
201885,University of Cincinnati-Main Campus,34379,29091,25873,8506
126614,University of Colorado Boulder,32017,28421,26242,5775
126580,University of Colorado Colorado Springs,11321,8945,7450,3871
126562,University of Colorado Denver,22206,15783,11800,10406
129020,University of Connecticut,25911,23756,22482,3429
436827,University of Connecticut-Avery Point,682,597,539,143
436836,University of Connecticut-Stamford,1363,1101,924,439
436818,University of Connecticut-Tri-Campus,2518,2189,1966,552
407683,University of Cosmetology Arts & Sciences-Harlingen,137,95,67,70
475662,University of Cosmetology Arts & Sciences-La Joya,103,71,50,53
229425,University of Cosmetology Arts & Sciences-McAllen,173,108,66,107
377193,University of Cosmetology Arts & Sciences-San Antonio Jamar,35,23,15,20
246415,University of Cosmetology Arts & Sciences-San Antonio Perrin,56,30,13,43
224323,University of Dallas,2598,2046,1705,893
202480,University of Dayton,10835,9948,9390,1445
130943,University of Delaware,22166,20651,19685,2481
127060,University of Denver,11778,9702,8411,3367
169716,University of Detroit Mercy,5112,4257,3716,1396
153278,University of Dubuque,2023,1858,1754,269
447801,University of East-West Medicine,177,141,118,59
150534,University of Evansville,2630,2510,2433,197
134130,University of Florida,49878,45282,42490,7388
457402,University of Fort Lauderdale,46,22,7,39
139959,University of Georgia,34536,32575,31364,3172
180258,University of Great Falls,1138,881,716,422
240754,University of Guam,3836,3205,2793,1043
129525,University of Hartford,6820,5834,5213,1607
141565,University of Hawaii at Hilo,4043,3547,3220,823
141574,University of Hawaii at Manoa,20006,16787,14803,5203
141839,University of Hawaii Maui College,4076,2516,1460,2616
141981,University of Hawaii-West Oahu,2361,1575,1043,1318
225511,University of Houston,39540,32856,28486,11054
225414,University of Houston-Clear Lake,8164,5436,3711,4453
225432,University of Houston-Downtown,13757,9680,6937,6820
225502,University of Houston-Victoria,4491,2864,1848,2643
142285,University of Idaho,12024,10405,9387,2637
145600,University of Illinois at Chicago,28038,25028,23239,4799
148654,University of Illinois at Springfield,5137,3554,2587,2550
145637,University of Illinois at Urbana-Champaign,44942,42550,41118,3824
151263,University of Indianapolis,5452,4324,3609,1843
153658,University of Iowa,29748,26370,24295,5453
200156,University of Jamestown,997,952,923,74
155317,University of Kansas,26968,24542,23034,3934
157085,University of Kentucky,28435,26728,25658,2777
117140,University of La Verne,8796,6807,5550,3246
160658,University of Louisiana at Lafayette,16646,14575,13221,3425
159993,University of Louisiana at Monroe,8645,6890,5739,2906
157289,University of Louisville,21444,18349,16364,5080
161253,University of Maine,11247,9699,8739,2508
161217,University of Maine at Augusta,4770,2954,1726,3044
161226,University of Maine at Farmington,2061,1888,1783,278
161235,University of Maine at Fort Kent,1209,842,594,615
161244,University of Maine at Machias,892,622,439,453
161341,University of Maine at Presque Isle,1263,938,718,545
437097,University of Management and Technology,1044,994,963,81
200217,University of Mary,2910,2194,1744,1166
226471,University of Mary Hardin-Baylor,3492,3190,2998,494
232681,University of Mary Washington,4831,4316,3989,842
163338,University of Maryland Eastern Shore,4220,3840,3601,619
163259,University of Maryland-Baltimore,6284,5491,5028,1256
163268,University of Maryland-Baltimore County,13908,11928,10699,3209
163286,University of Maryland-College Park,37272,34123,32199,5073
163204,University of Maryland-University College,39557,19093,6131,33426
166708,University of Massachusetts Medical School Worcester,1161,1094,1056,105
166629,University of Massachusetts-Amherst,28518,24941,22808,5710
166638,University of Massachusetts-Boston,16277,12421,9999,6278
167987,University of Massachusetts-Dartmouth,9053,7825,7060,1993
166513,University of Massachusetts-Lowell,16932,12868,10322,6610
220862,University of Memphis,21480,17157,14385,7095
135726,University of Miami,16935,16116,15597,1338
170976,University of Michigan-Ann Arbor,43710,42118,41152,2558
171137,University of Michigan-Dearborn,8748,6597,5225,3523
171146,University of Michigan-Flint,8555,6360,4943,3612
174075,University of Minnesota-Crookston,2839,1924,1305,1534
174233,University of Minnesota-Duluth,11241,10276,9658,1583
174251,University of Minnesota-Morris,1946,1868,1815,131
456959,University of Minnesota-Rochester,495,478,467,28
174066,University of Minnesota-Twin Cities,51526,43612,38767,12759
176017,University of Mississippi,19431,18314,17612,1819
176026,University of Mississippi Medical Center,2268,1778,1478,790
178396,University of Missouri-Columbia,34616,31942,30318,4298
178402,University of Missouri-Kansas City,15718,12158,9917,5801
178420,University of Missouri-St Louis,16809,10856,6988,9821
101693,University of Mobile,1610,1413,1288,322
101709,University of Montevallo,3062,2731,2526,536
204185,University of Mount Union,2187,2145,2118,69
181215,University of Nebraska at Kearney,7052,5794,5034,2018
181394,University of Nebraska at Omaha,15227,12247,10374,4853
181428,University of Nebraska Medical Center,3681,3332,3126,555
181464,University of Nebraska-Lincoln,24445,22223,20880,3565
182281,University of Nevada-Las Vegas,27848,22345,18795,9053
182290,University of Nevada-Reno,18776,15976,14208,4568
161457,University of New England,6032,5376,4961,1071
183071,University of New Hampshire at Manchester,926,727,599,327
183044,University of New Hampshire-Main Campus,14913,13925,13336,1577
182829,University of New Hampshire-School of Law,315,305,299,16
129941,University of New Haven,6555,5810,5342,1213
187958,University of New Mexico-Gallup Campus,2675,1730,1252,1423
187976,University of New Mexico-Los Alamos Campus,744,377,191,553
187985,University of New Mexico-Main Campus,28592,23757,20668,7924
188225,University of New Mexico-Taos Campus,1802,952,522,1280
188049,University of New Mexico-Valencia County Campus,2245,1417,998,1247
159939,University of New Orleans,9323,7626,6548,2775
101879,University of North Alabama,6931,5829,5133,1798
199111,University of North Carolina at Asheville,3784,3391,3129,655
199120,University of North Carolina at Chapel Hill,29127,26137,24390,4737
199139,University of North Carolina at Charlotte,26571,22789,20436,6135
199148,University of North Carolina at Greensboro,18074,15479,13858,4216
199281,University of North Carolina at Pembroke,6222,5163,4485,1737
199184,University of North Carolina School of the Arts,912,902,895,17
199218,University of North Carolina Wilmington,13937,12745,12001,1936
200280,University of North Dakota,15143,12699,11160,3983
136172,University of North Florida,16083,12904,10829,5254
482680,University of North Georgia,15455,12306,10205,5250
227216,University of North Texas,38315,31570,27282,11033
228909,University of North Texas Health Science Center,2142,2018,1947,195
127741,University of Northern Colorado,12710,10862,9735,2975
154095,University of Northern Iowa,12159,10804,9968,2191
204486,University of Northwestern Ohio,4167,3864,3669,498
174491,University of Northwestern-St Paul,3352,2521,1986,1366
152080,University of Notre Dame,12124,11991,11908,216
207342,University of Oklahoma-Health Sciences Center,3515,3164,2963,552
207500,University of Oklahoma-Norman Campus,27292,23181,20627,6665
209551,University of Oregon,24473,22923,21920,2553
215062,University of Pennsylvania,24630,22612,21344,3286
405997,University of Phoenix-Albuquerque Campus,2462,2462,2462,0
442152,University of Phoenix-Atlanta Campus,1510,1510,1510,0
450474,University of Phoenix-Augusta Campus,827,827,827,0
446747,University of Phoenix-Austin Campus,756,756,756,0
474951,University of Phoenix-Baton Rouge Campus,570,569,570,0
406006,University of Phoenix-Bay Area Campus,1655,1655,1655,0
450456,University of Phoenix-Birmingham Campus,301,301,301,0
440420,University of Phoenix-Boston Campus,210,210,210,0
432232,University of Phoenix-Central Florida Campus,843,842,843,0
445717,University of Phoenix-Central Valley Campus,2725,2725,2725,0
443474,University of Phoenix-Charlotte Campus,933,933,933,0
450492,University of Phoenix-Chattanooga Campus,454,454,454,0
442161,University of Phoenix-Chicago Campus,882,882,882,0
443456,University of Phoenix-Cincinnati Campus,119,119,119,0
439297,University of Phoenix-Cleveland Campus,385,385,385,0
405988,University of Phoenix-Colorado Campus,1474,1474,1474,0
448567,University of Phoenix-Columbia Campus,784,784,784,0
443881,University of Phoenix-Columbus Georgia Campus,889,889,889,0
443906,University of Phoenix-Columbus Ohio Campus,61,61,61,0
440439,University of Phoenix-Dallas Campus,1499,1499,1499,0
462406,University of Phoenix-Delaware Campus,31,31,31,0
446729,University of Phoenix-Des Moines Campus,61,61,61,0
421018,University of Phoenix-Detroit Campus,1249,1249,1249,0
448822,University of Phoenix-Fairfield County Campus,20,20,20,0
448831,University of Phoenix-Harrisburg Campus,60,60,60,0
420042,University of Phoenix-Hawaii Campus,1454,1454,1454,0
440448,University of Phoenix-Houston Campus,1841,1841,1841,0
440466,University of Phoenix-Idaho Campus,307,307,307,0
443544,University of Phoenix-Indianapolis Campus,372,372,372,0
462390,University of Phoenix-Jackson Campus,66,66,66,0
445300,University of Phoenix-Jersey City Campus,455,455,455,0
442143,University of Phoenix-Kansas City Campus,567,567,567,0
474702,University of Phoenix-Knoxville Campus,98,98,98,0
474960,University of Phoenix-Lafayette Campus,91,91,91,0
416962,University of Phoenix-Las Vegas Campus,2180,2180,2180,0
443924,University of Phoenix-Little Rock Campus,611,611,611,0
421009,University of Phoenix-Louisiana Campus,524,525,524,0
445391,University of Phoenix-Louisville Campus,216,216,216,0
448558,University of Phoenix-Madison Campus,54,54,54,0
434973,University of Phoenix-Maryland Campus,560,560,560,0
479770,University of Phoenix-McAllen Campus,139,139,139,0
443890,University of Phoenix-Memphis Campus,1249,1249,1249,0
440457,University of Phoenix-Milwaukee Campus,268,268,268,0
445319,University of Phoenix-Minneapolis St Paul Campus,180,180,180,0
442170,University of Phoenix-Nashville Campus,1436,1436,1436,0
434955,University of Phoenix-North Florida Campus,1238,1238,1238,0
447661,University of Phoenix-Northern Nevada Campus,158,158,158,0
442189,University of Phoenix-Northern Virginia Campus,865,865,865,0
448530,University of Phoenix-Northwest Arkansas Campus,424,424,424,0
434982,University of Phoenix-Oklahoma City Campus,433,434,433,0
448521,University of Phoenix-Omaha Campus,34,34,34,0
372213,University of Phoenix-Online Campus,212044,212044,212044,0
432241,University of Phoenix-Oregon Campus,694,694,694,0
438610,University of Phoenix-Philadelphia Campus,739,739,739,0
105516,University of Phoenix-Phoenix Campus,4480,4480,4480,0
438629,University of Phoenix-Pittsburgh Campus,43,43,43,0
382063,University of Phoenix-Puerto Rico Campus,928,928,928,0
446765,University of Phoenix-Raleigh Campus,166,166,166,0
446756,University of Phoenix-Richmond-Virginia Beach Campus,706,706,706,0
419509,University of Phoenix-Sacramento Valley Campus,3421,3421,3421,0
446738,University of Phoenix-San Antonio Campus,1048,1048,1048,0
372222,University of Phoenix-San Diego Campus,6122,6122,6122,0
447652,University of Phoenix-Savannah Campus,391,391,391,0
474979,University of Phoenix-Shreveport-Bossier Campus,136,136,136,0
434946,University of Phoenix-South Florida Campus,1364,1364,1364,0
405979,University of Phoenix-Southern Arizona Campus,1849,1849,1849,0
406015,University of Phoenix-Southern California Campus,9954,9954,9954,0
438382,University of Phoenix-Southern Colorado Campus,632,632,632,0
446710,University of Phoenix-Springfield  Campus,58,58,58,0
439279,University of Phoenix-St Louis Campus,575,575,575,0
434991,University of Phoenix-Tulsa Campus,435,434,435,0
380465,University of Phoenix-Utah Campus,1703,1703,1703,0
450483,University of Phoenix-Washington DC Campus,313,313,313,0
434964,University of Phoenix-West Florida Campus,717,718,717,0
438416,University of Phoenix-West Michigan Campus,306,306,306,0
432223,University of Phoenix-Western Washington Campus,642,642,642,0
443465,University of Phoenix-Wichita Campus,67,67,67,0
157535,University of Pikeville,2205,1928,1749,456
215974,University of Pittsburgh Medical Center-Shadyside School of Nursing,346,300,269,77
215266,University of Pittsburgh-Bradford,1481,1409,1361,120
215275,University of Pittsburgh-Greensburg,1677,1610,1564,113
215284,University of Pittsburgh-Johnstown,2840,2788,2753,87
215293,University of Pittsburgh-Pittsburgh Campus,28649,26411,25069,3580
215309,University of Pittsburgh-Titusville,367,321,297,70
209825,University of Portland,4036,3715,3515,521
243106,University of Puerto Rico-Aguadilla,2973,2815,2708,265
243115,University of Puerto Rico-Arecibo,3759,3578,3456,303
243133,University of Puerto Rico-Bayamon,5075,4616,4305,770
243142,University of Puerto Rico-Carolina,3994,3494,3155,839
243151,University of Puerto Rico-Cayey,3816,3645,3530,286
243179,University of Puerto Rico-Humacao,3495,3259,3099,396
243197,University of Puerto Rico-Mayaguez,11838,11370,11057,781
243203,University of Puerto Rico-Medical Sciences,2253,2172,2123,130
243212,University of Puerto Rico-Ponce,3120,2977,2881,239
243221,University of Puerto Rico-Rio Piedras,15487,14299,13538,1949
243188,University of Puerto Rico-Utuado,1559,1500,1460,99
236328,University of Puget Sound,2812,2778,2756,56
121691,University of Redlands,5147,4391,3907,1240
217484,University of Rhode Island,16387,14711,13662,2725
233374,University of Richmond,4140,3780,3554,586
205203,University of Rio Grande,2314,2006,1808,506
195030,University of Rochester,11020,9951,9284,1736
152336,University of Saint Francis-Fort Wayne,2381,2035,1815,566
130314,University of Saint Joseph,2640,1765,1220,1420
155812,University of Saint Mary,1325,1075,914,411
148885,University of Saint Mary of the Lake,233,233,233,0
122436,University of San Diego,8321,7547,7066,1255
122612,University of San Francisco,10112,9585,9255,857
207722,University of Science and Arts of Oklahoma,918,851,805,113
215929,University of Scranton,5633,5136,4826,807
219383,University of Sioux Falls,1408,1119,938,470
102094,University of South Alabama,15065,13233,12028,3037
218645,University of South Carolina-Aiken,3299,2776,2430,869
218654,University of South Carolina-Beaufort,1724,1516,1376,348
218663,University of South Carolina-Columbia,31964,29517,28022,3942
218672,University of South Carolina-Lancaster,1811,1131,787,1024
218681,University of South Carolina-Salkehatchie,1021,741,600,421
218690,University of South Carolina-Sumter,924,660,526,398
218706,University of South Carolina-Union,484,319,236,248
218742,University of South Carolina-Upstate,5445,4719,4236,1209
219471,University of South Dakota,10235,7673,6031,4204
137351,University of South Florida-Main Campus,41428,34082,29437,11991
451671,University of South Florida-Sarasota-Manatee,1877,1275,875,1002
448840,University of South Florida-St Petersburg,4660,3525,2792,1868
123961,University of Southern California,41368,37994,35895,5473
151306,University of Southern Indiana,9902,8441,7513,2389
161554,University of Southern Maine,8923,6550,5020,3903
176372,University of Southern Mississippi,15249,13446,12317,2932
134121,University of Southernmost Florida,103,103,103,0
149550,University of Spa & Cosmetology Arts,189,153,130,59
367954,University of St Augustine for Health Sciences,1705,1494,1363,342
148584,University of St Francis,3764,2424,1589,2175
227863,University of St Thomas,3525,2353,1623,1902
174914,University of St Thomas,10192,8381,7257,2935
228635,University of Texas Southwestern Medical Center,2374,1987,1768,606
156541,University of the Cumberlands,4924,3395,2439,2485
131399,University of the District of Columbia,5011,3330,2199,2812
363721,University of the District of Columbia-David A Clarke School of Law,336,246,195,141
225627,University of the Incarnate Word,8685,6590,5254,3431
107558,University of the Ozarks,585,576,571,14
120883,University of the Pacific,6421,6007,5749,672
442639,University of the Potomac-VA Campus,35,35,35,0
384412,University of the Potomac-Washington DC Campus,341,341,341,0
441308,University of the Rockies,1797,1659,1573,224
215132,University of the Sciences,2773,2624,2532,241
188182,University of the Southwest,923,576,359,564
243665,University of the Virgin Islands,2321,1764,1396,925
449870,University of the West,362,327,305,57
206084,University of Toledo,20743,17960,16179,4564
207971,University of Tulsa,4597,4293,4102,495
230764,University of Utah,32077,26637,23084,8993
231174,University of Vermont,12723,11672,11001,1722
234076,University of Virginia-Main Campus,23464,21988,21086,2378
377555,University of Washington-Bothell Campus,4604,4054,3699,905
236948,University of Washington-Seattle Campus,43762,40406,38327,5435
377564,University of Washington-Tacoma Campus,4295,3785,3463,832
101587,University of West Alabama,4427,4097,3890,537
141334,University of West Georgia,11929,10169,9067,2862
210438,University of Western States,682,563,488,194
240055,University of Wisconsin Colleges,13947,10007,8015,5932
240268,University of Wisconsin-Eau Claire,10923,10126,9616,1307
240277,University of Wisconsin-Green Bay,6668,5301,4388,2280
240329,University of Wisconsin-La Crosse,10520,9940,9577,943
240444,University of Wisconsin-Madison,42677,40055,38428,4249
240453,University of Wisconsin-Milwaukee,27416,23826,21548,5868
240365,University of Wisconsin-Oshkosh,13900,11155,9375,4525
240374,University of Wisconsin-Parkside,4578,3851,3365,1213
240462,University of Wisconsin-Platteville,8712,7741,7136,1576
240471,University of Wisconsin-River Falls,6160,5681,5375,785
240480,University of Wisconsin-Stevens Point,9661,9120,8770,891
240417,University of Wisconsin-Stout,9313,7951,7088,2225
240426,University of Wisconsin-Superior,2661,2306,2071,590
240189,University of Wisconsin-Whitewater,12027,10971,10308,1719
240727,University of Wyoming,12778,10919,9743,3035
373711,Upper Cape Cod Regional Technical School,59,59,59,0
154493,Upper Iowa University,5304,4300,3651,1653
206321,Upper Valley Career Center,405,161,38,367
440004,Upper Valley Educators Institute,35,35,35,0
196307,Upstate Medical University,1617,1400,1272,345
429128,Urban College of Boston,762,320,29,733
206330,Urbana University,1748,1162,786,962
455099,Urshan Graduate School of Theology,68,32,9,59
216524,Ursinus College,1596,1587,1582,14
206349,Ursuline College,1357,908,626,731
446604,Uta Mesivta of Kiryas Joel,1561,1561,1561,0
469160,Utah College of Massage Therapy-Aurora,248,178,132,116
476346,Utah College of Massage Therapy-Dallas,310,233,183,127
481942,Utah College of Massage Therapy-Houston,350,264,208,142
469142,Utah College of Massage Therapy-Phoenix,459,326,238,221
380474,Utah College of Massage Therapy-Salt Lake City,346,254,193,153
469133,Utah College of Massage Therapy-Tempe,326,241,185,141
436270,Utah College of Massage Therapy-Utah Valley,158,113,83,75
469124,Utah College of Massage Therapy-Vegas,453,321,234,219
469151,Utah College of Massage Therapy-Westminster,191,135,98,93
230728,Utah State University,27812,20933,16436,11376
230737,Utah Valley University,30564,21723,15755,14809
197045,Utica College,4028,3056,2444,1584
197081,Utica School of Commerce,324,262,222,102
141264,Valdosta State University,11885,10081,8964,2921
138187,Valencia College,42180,26877,16523,25657
206358,Valley Beauty School,29,29,29,0
201584,Valley Beauty School,19,19,19,0
200572,Valley City State University,1366,999,761,605
449445,Valley College of Medical Careers,90,90,90,0
377652,Valley College-Beckley,223,223,223,0
377661,Valley College-Martinsburg,55,55,55,0
377670,Valley College-Princeton,66,66,66,0
216542,Valley Forge Christian College,1004,815,694,310
216551,Valley Forge Military College,268,268,268,0
443322,Valley Grande Institute for Academic Studies,118,118,118,0
152600,Valparaiso University,4508,4234,4062,446
199838,Vance-Granville Community College,4008,2068,1087,2921
221999,Vanderbilt University,12757,12268,11965,792
149639,VanderCook College of Music,178,135,108,70
456825,Vanguard College of Cosmetology-Baton Rouge,106,106,106,0
468893,Vanguard College of Cosmetology-Metairie,123,123,123,0
160445,Vanguard College of Cosmetology-Slidell,107,107,107,0
123651,Vanguard University of Southern California,2415,1966,1678,737
421717,Vanguard-Sentinel Adult Career and Technology Center,54,54,54,0
457891,Vanity School of Cosmetology,53,53,53,0
418278,Vantage Career Center,62,40,29,33
197133,Vassar College,2477,2453,2437,40
455567,Vatterott College-Appling Farms,355,355,355,0
245342,Vatterott College-Berkeley,1344,1344,1344,0
442408,Vatterott College-Cleveland,229,229,229,0
373058,Vatterott College-Des Moines,239,239,239,0
440873,Vatterott College-Dividend,882,882,882,0
481988,Vatterott College-ex'treme Institute by Nelly-St Louis,402,402,402,0
480514,Vatterott College-Fairview Heights,493,493,493,0
404374,Vatterott College-Joplin,236,236,236,0
404383,Vatterott College-Kansas City,540,540,540,0
437060,Vatterott College-Oklahoma City,280,280,280,0
148140,Vatterott College-Quincy,200,200,200,0
181756,Vatterott College-Spring Valley,330,330,330,0
404365,Vatterott College-Springfield,312,312,312,0
445559,Vatterott College-St Charles,305,305,305,0
436182,Vatterott College-St Joseph,231,231,231,0
436191,Vatterott College-Sunset Hills,624,624,624,0
440882,Vatterott College-Tulsa,164,164,164,0
440891,Vatterott College-Wichita,209,209,209,0
188340,Vaughn College of Aeronautics and Technology,1741,1478,1308,433
417910,Veeb Nassau County School of Practical Nursing,158,158,158,0
108065,Velvatex College of Beauty Culture,25,21,19,6
476762,Velvet Touch Academy of Cosmetology,61,61,61,0
418524,Venango County Area Vocational Technical School,65,65,65,0
417123,Ventura Adult and Continuing Education,142,126,118,24
125028,Ventura College,12908,7248,4387,8521
216579,Venus Beauty Academy,112,112,112,0
175157,Vermilion Community College,711,568,496,215
455992,Vermont College of Fine Arts,359,359,359,0
231147,Vermont Law School,675,530,441,234
231165,Vermont Technical College,1543,1248,1049,494
229504,Vernon College,3084,1765,1099,1985
213914,Vet Tech Institute,385,385,385,0
223472,Vet Tech Institute of Houston,196,196,196,0
238175,VICI Aveda Institute,136,136,136,0
125082,Victor Valley Beauty College Inc,105,103,101,4
125091,Victor Valley College,11504,6539,4030,7474
229522,Victoria Beauty College Inc,26,15,7,19
229540,Victoria College,4419,2404,1385,3034
451626,Victoria's Academy of Cosmetology,93,85,80,13
459435,Victory Trade School,27,27,27,0
220941,Victory University,2496,1862,1452,1044
449375,Video Symphony EnterTraining Inc,78,62,52,26
197142,Villa Maria College,465,399,356,109
216597,Villanova University,10696,8959,7876,2820
441335,Vinal Technical High School,29,29,29,0
152628,Vincennes Beauty College,89,60,41,48
152637,Vincennes University,18383,11026,6049,12334
208017,Virgil's Beauty College,32,32,32,0
482228,Virginia Baptist College,108,59,28,80
377485,Virginia Beach City Public Schools School of Practical Nursing,58,32,19,39
458256,Virginia College-Augusta,902,704,576,326
441928,Virginia College-Austin,642,445,315,327
460774,Virginia College-Baton Rouge,600,489,416,184
450191,Virginia College-Biloxi,470,381,322,148
420307,Virginia College-Birmingham,3877,3012,2453,1424
456056,Virginia College-Charleston,425,359,316,109
458593,Virginia College-Columbia,550,448,381,169
475370,Virginia College-Columbus,741,635,566,175
480107,Virginia College-Florence,458,385,337,121
480815,Virginia College-Greensboro,468,409,370,98
454625,Virginia College-Greenville,460,368,307,153
420316,Virginia College-Huntsville,567,464,398,169
441919,Virginia College-Jackson,376,318,279,97
455716,Virginia College-Jacksonville,629,531,467,162
475617,Virginia College-Knoxville,602,475,393,209
460844,Virginia College-Macon,451,378,330,121
445090,Virginia College-Mobile,561,479,425,136
452115,Virginia College-Montgomery,656,537,458,198
389727,Virginia College-Pensacola,365,293,246,119
460923,Virginia College-Richmond,506,447,408,98
475352,Virginia College-Savannah,620,519,453,167
450289,Virginia College-School of Business and Health-Chattanooga,410,321,262,148
475866,Virginia College-Shreveport Bossier City,264,232,211,53
460853,Virginia College-Spartanburg,495,386,315,180
475592,Virginia College-Tulsa,121,102,90,31
234030,Virginia Commonwealth University,30974,27186,24803,6171
233903,Virginia Highlands Community College,2484,1539,1061,1423
233912,Virginia Intermont College,378,351,333,45
206394,Virginia Marti College of Art and Design,173,125,94,79
234085,Virginia Military Institute,1675,1675,1675,0
233921,Virginia Polytechnic Institute and State University,31205,29452,28425,2780
234119,Virginia School of Hair Design,89,59,40,49
430254,Virginia School of Massage,56,46,40,16
431956,Virginia Sewing Machines and School Center,66,66,66,0
234155,Virginia State University,5763,5391,5164,599
234164,Virginia Union University,1749,1719,1700,49
234137,Virginia University of Lynchburg,582,426,326,256
234173,Virginia Wesleyan College,1459,1392,1349,110
233949,Virginia Western Community College,8654,4691,2688,5966
449764,Visible Music College,118,113,110,8
455415,Visions in Hair Design Institute of Cosmetology,18,13,10,8
365204,Vista College,2746,2746,2746,0
377342,Vista College-Online,207,207,207,0
240107,Viterbo University,2762,2251,1926,836
431965,Vogue Beauty and Barber School,144,144,144,0
476559,Vogue College of Cosmetology,137,117,104,33
229656,Vogue College of Cosmetology-McAllen,232,211,198,34
476540,Vogue College of Cosmetology-San Antonio Fredericksburg,118,107,100,18
188289,Vogue College of Cosmetology-Santa Fe,76,71,67,9
222026,Volunteer Beauty Academy-Dyersburg,59,43,33,26
392798,Volunteer Beauty Academy-Madison,44,35,29,15
403414,Volunteer Beauty Academy-Nashville,41,27,17,24
222053,Volunteer State Community College,8153,5027,3447,4706
218919,Voorhees College,536,524,516,20
481474,W Academy of Salon and Spa,36,28,23,13
417257,W F Kaynor Technical High School,39,39,39,0
152673,Wabash College,902,902,902,0
403487,Wabash Valley College,4512,1883,554,3958
226879,Wade College,201,177,162,39
476896,Wade Gordon Hairdressing Academy,99,99,99,0
197197,Wagner College,2245,2085,1985,260
199847,Wake Forest University,7602,7462,7375,227
199856,Wake Technical Community College,19160,10409,5986,13174
125231,Walden University,51016,37761,29437,21579
154518,Waldorf College,1150,1012,923,227
236887,Walla Walla Community College,5109,3687,2969,2140
236896,Walla Walla University,1917,1847,1802,115
172608,Walsh College of Accountancy and Business Administration,2864,1230,204,2660
206437,Walsh University,2963,2446,2118,845
222062,Walters State Community College,6265,4210,3171,3094
457378,Walton Career Development Center,130,123,120,10
234191,Wards Corner Beauty Academy-Norfolk,152,152,152,0
445683,Wards Corner Beauty Academy-Virginia Beach,35,35,35,0
210304,Warner Pacific College,506,484,470,36
480198,Warner Pacific College Adult Degree Program,918,918,918,0
138275,Warner University,1162,1048,975,187
407832,Warren County Career Center,392,322,287,105
245625,Warren County Community College,2358,1404,922,1436
199865,Warren Wilson College,893,889,887,6
417655,Warrensburg Area Career Center,40,40,40,0
154527,Wartburg College,1714,1671,1643,71
154536,Wartburg Theological Seminary,139,132,127,12
155423,Washburn Institute of Technology,1162,564,262,900
156082,Washburn University,6973,5522,4562,2411
216667,Washington & Jefferson College,1328,1322,1318,10
162210,Washington Adventist University,1185,995,874,311
234207,Washington and Lee University,2277,2275,2273,4
457192,Washington Barber College Inc,126,126,126,0
164216,Washington College,1512,1469,1441,71
234225,Washington County Adult Skill Center,81,81,81,0
418250,Washington County Career Center-Adult Technical Training,261,210,184,77
161581,Washington County Community College,463,349,291,172
216630,Washington Hospital School of Nursing,76,76,76,0
216649,Washington Hospital School of Radiography,25,25,25,0
418029,Washington Saratoga Warren Hamilton Essex BOCES-Practical Nursing Program,46,39,36,10
206446,Washington State Community College,1759,1069,721,1038
236939,Washington State University,27642,25180,23604,4038
179867,Washington University in St Louis,14032,12833,12078,1954
138284,Washington-Holmes Technical Center,349,328,318,31
172617,Washtenaw Community College,12327,6635,3758,8569
392840,Watkins College of Art Design & Film,363,295,251,112
199883,Watts School of Nursing,138,138,138,0
149727,Waubonsee Community College,10721,5904,3469,7252
240125,Waukesha County Technical College,8799,4220,1905,6894
229780,Wayland Baptist University,6222,3177,1235,4987
199892,Wayne Community College,3837,2493,1813,2024
172635,Wayne County Community College District,18119,8649,3862,14257
433138,Wayne County Schools Career Center,360,286,248,112
418001,Wayne Finger Lakes BOCES-Practical Nursing Program,283,283,283,0
181783,Wayne State College,3506,3076,2815,691
172644,Wayne State University,27897,21908,18096,9801
125310,Waynes College of Beauty,42,35,30,12
216694,Waynesburg University,2190,1804,1563,627
365505,Waynesville Career Center,55,55,55,0
229799,Weatherford College,5694,3534,2443,3251
197221,Webb Institute,82,82,82,0
138293,Webber International University,715,688,671,44
230782,Weber State University,25155,16789,11155,14000
179894,Webster University,17904,10424,5783,12121
190424,Weill Cornell Medical College,1043,1026,1015,28
220206,Welch College,338,275,234,104
216746,Welder Training and Testing Institute,88,77,70,18
168218,Wellesley College,2474,2395,2344,130
197230,Wells College,534,528,524,10
447999,WellSpring School of Allied Health-Kansas City,125,125,125,0
470047,WellSpring School of Allied Health-Lawrence,28,28,28,0
236975,Wenatchee Valley College,3619,2958,2624,995
168227,Wentworth Institute of Technology,4179,3902,3724,455
179919,Wentworth Military Academy & Junior College,851,541,337,514
418357,Wes Watkins Technology Center,198,135,103,95
176451,Wesley Biblical Seminary,44,21,7,37
131098,Wesley College,1655,1538,1463,192
131973,Wesley Theological Seminary,628,483,393,235
141325,Wesleyan College,700,589,517,183
130697,Wesleyan University,3205,3135,3091,114
216764,West Chester University of Pennsylvania,15845,14241,13250,2595
441229,West Coast Ultrasound Institute,796,796,796,0
477039,West Coast University-Dallas,320,304,294,26
443331,West Coast University-Los Angeles,1435,1395,1369,66
458229,West Coast University-Ontario,1103,1065,1041,62
458210,West Coast University-Orange County,1528,1461,1418,110
139278,West Georgia Technical College,6915,3798,2223,4692
125462,West Hills College-Coalinga,3055,1657,951,2104
448594,West Hills College-Lemoore,4102,2281,1361,2741
157483,West Kentucky Community and Technical College,7104,4033,2481,4623
237932,West Liberty University,2776,2472,2269,507
125471,West Los Angeles College,10767,5050,2160,8607
152044,West Michigan College of Barbering and Beauty,87,44,15,72
172671,West Shore Community College,1487,840,513,974
222099,West Tennessee Business College,212,210,209,3
229814,West Texas A & M University,8377,6934,6025,2352
125499,West Valley College,9636,5271,3065,6571
237978,West Virginia Business College-Wheeling,147,147,147,0
442383,West Virginia Junior College-Bridgeport,210,200,194,16
237987,West Virginia Junior College-Charleston,213,207,203,10
237996,West Virginia Junior College-Morgantown,291,291,291,0
238014,West Virginia Northern Community College,2086,1333,952,1134
237880,West Virginia School of Osteopathic Medicine,817,817,817,0
237899,West Virginia State University,2677,2226,1922,755
238032,West Virginia University,29466,27196,25796,3670
237686,West Virginia University at Parkersburg,3461,2666,2128,1333
237905,West Virginia University Hospital Departments of Rad Tech and Nutrition,49,49,49,0
237950,West Virginia University Institute of Technology,1222,1070,967,255
237969,West Virginia Wesleyan College,1469,1447,1433,36
197337,Westchester School of Beauty Culture,116,88,70,46
382276,Westech College,484,427,390,94
368407,Western Area Career and Technology Center,90,73,64,26
460686,Western Beauty Institute,143,135,129,14
112783,Western Beauty Institute,268,267,266,2
200004,Western Carolina University,10107,8660,7750,2357
130776,Western Connecticut State University,6025,5075,4465,1560
219480,Western Dakota Technical Institute,1030,874,795,235
433387,Western Governors University,46733,46733,46733,0
206482,Western Hills School of Beauty and Hair Design,259,194,152,107
149772,Western Illinois University,11707,10410,9605,2102
106102,Western International University,2042,2042,2042,0
154572,Western Iowa Tech Community College,6331,3759,2459,3872
157951,Western Kentucky University,20448,16706,14315,6133
172699,Western Michigan University,24294,19804,17042,7252
181817,Western Nebraska Community College,1960,1272,924,1036
182564,Western Nevada College,3975,2338,1230,2745
168254,Western New England University,3800,3280,2955,845
188304,Western New Mexico University,3560,2409,1669,1891
208035,Western Oklahoma State College,1690,1016,675,1015
210429,Western Oregon University,6177,5282,4720,1457
216773,Western Pennsylvania Hospital School of Nursing,95,95,95,0
199908,Western Piedmont Community College,2352,1615,1242,1110
210368,Western Seminary,767,352,96,671
126030,Western State College of Law at Argosy University,431,338,280,151
128391,Western State Colorado University,2404,2155,1993,411
420468,Western Suffolk BOCES,366,280,236,130
224679,Western Technical College,815,715,649,166
240170,Western Technical College,4572,2810,1920,2652
224660,Western Technical College,651,560,500,151
418302,Western Technology Center,459,231,116,343
229832,Western Texas College,2044,1090,608,1436
172705,Western Theological Seminary,275,221,187,88
112525,Western University of Health Sciences,3748,3708,3684,64
237011,Western Washington University,14950,14042,13457,1493
240693,Western Wyoming Community College,3620,2027,1222,2398
168263,Westfield State University,6371,5665,5220,1151
476470,WestMed College,356,356,356,0
216807,Westminster College,1366,1304,1264,102
179946,Westminster College,1026,1021,1018,8
230807,Westminster College,3108,2845,2680,428
216816,Westminster Theological Seminary,588,394,274,314
125718,Westminster Theological Seminary in California,143,123,111,32
125727,Westmont College,1321,1315,1311,10
216825,Westmoreland County Community College,6104,4020,2967,3137
138372,Westside Tech,703,573,508,195
437848,Westwood College-Anaheim,772,646,564,208
448628,Westwood College-Annandale,348,291,254,94
447069,Westwood College-Arlington Ballston,371,306,264,107
445072,Westwood College-Atlanta Midtown,448,388,349,99
443687,Westwood College-Chicago Loop,417,371,341,76
127024,Westwood College-Denver North,438,360,310,128
381787,Westwood College-Denver South,275,220,185,90
406194,Westwood College-Dupage,186,150,127,59
440484,Westwood College-Inland Empire,979,813,706,273
122843,Westwood College-Los Angeles,672,565,496,176
445276,Westwood College-Northlake,420,370,337,83
178226,Westwood College-O'Hare Airport,298,257,230,68
440147,Westwood College-River Oaks,321,293,275,46
121381,Westwood College-South Bay,571,503,459,112
229841,Wharton County Junior College,7386,4342,2803,4583
237039,Whatcom Community College,4427,3124,2466,1961
168281,Wheaton College,1654,1649,1645,9
149781,Wheaton College,2993,2791,2665,328
238078,Wheeling Jesuit University,1619,1293,1087,532
168290,Wheelock College,1378,1185,1065,313
434751,White Earth Tribal and Community College,60,46,36,24
183105,White Mountains Community College,937,493,268,669
237057,Whitman College,1541,1519,1505,36
125763,Whittier College,2339,2170,2065,274
237066,Whitworth University,2569,2448,2373,196
475200,Whitworth University-Adult Degree Programs,313,140,28,285
156107,Wichita Area Technical College,2934,1707,1087,1847
156125,Wichita State University,14386,11824,10184,4202
156134,Wichita Technical Institute,967,967,967,0
244190,Widener University-Delaware Campus,905,792,720,185
402828,Widener University-Harrisburg Campus,381,324,289,92
216852,Widener University-Main Campus,5025,4134,3573,1452
206491,Wilberforce University,479,471,466,13
229887,Wiley College,1392,1353,1327,65
199926,Wilkes Community College,2753,1921,1500,1253
216931,Wilkes University,4665,3434,2670,1995
365383,Wilkes-Barre Area Career and Technical Center Practical Nursing,119,119,119,0
210401,Willamette University,2855,2736,2660,195
176479,William Carey University,3882,3233,2826,1056
122728,William Jessup University,1095,951,859,236
179955,William Jewell College,1044,1025,1012,32
175281,William Mitchell College of Law,813,652,553,260
222105,William Moore College of Technology,219,139,86,133
187444,William Paterson University of New Jersey,11414,9675,8575,2839
199272,William Peace University,1007,927,875,132
154590,William Penn University,1875,1741,1655,220
138479,William T McFatter Technical Center,827,827,827,0
179964,William Woods University,2136,1597,1261,875
107877,Williams Baptist College,574,521,486,88
168342,Williams College,2150,2131,2118,32
218955,Williamsburg Technical College,729,435,287,442
443340,Williamson Christian College,72,71,71,1
200341,Williston State College,909,591,430,479
418223,Willoughby-Eastlake School of Practical Nursing,67,67,67,0
206507,Wilmington College,1173,1087,1031,142
131113,Wilmington University,13621,8162,4698,8923
217013,Wilson College,662,461,332,330
199953,Wilson Community College,2117,1423,1072,1045
369792,Windham Memorial Hospital-Radiologic Technology Program,17,17,17,0
441353,Windham Technical High School,16,16,16,0
141990,Windward Community College,2799,1577,959,1840
206516,Winebrenner Theological Seminary,60,38,25,35
199962,Wingate University,3002,2666,2457,545
175272,Winona State University,8782,7993,7487,1295
199980,Winston Salem Barber School,60,60,60,0
199999,Winston-Salem State University,5399,4924,4614,785
138488,Winter Park Tech,437,264,177,260
218964,Winthrop University,6130,5389,4928,1202
141255,Wiregrass Georgia Technical College,3966,2252,1386,2580
451653,Wisconsin Academy,30,30,30,0
240198,Wisconsin Indianhead Technical College,3418,2123,1469,1949
240338,Wisconsin Lutheran College,1178,1076,1011,167
240213,Wisconsin School of Professional Psychology,92,60,40,52
138497,Withlacoochee Technical Institute,288,288,288,0
206525,Wittenberg University,1979,1902,1853,126
218973,Wofford College,1615,1605,1598,17
451130,Wolford College,213,211,210,3
442064,Won Institute of Graduate Studies,86,80,76,10
238096,Wood County School of Practical Nursing,35,35,35,0
197522,Wood Tobe-Coburn School,476,476,476,0
125897,Woodbury University,1607,1477,1393,214
455512,Woodland Community College,2641,1438,830,1811
234359,Woodrow Wilson Rehabilitation Center,164,164,164,0
481146,Woodruff Medical Training and Testing,100,100,100,0
208044,Woodward Beauty College,27,27,27,0
164313,Wor-Wic Community College,3416,1872,1091,2325
168421,Worcester Polytechnic Institute,6296,5323,4719,1577
168430,Worcester State University,6447,5116,4268,2179
197531,Word of Life Bible Institute,562,562,562,0
481067,World A Cuts Barber Institute,31,26,22,9
141936,World Medicine Institute,64,64,64,0
401223,World Mission University,261,203,167,94
369455,Worsham College of Mortuary Science,108,108,108,0
170514,Wright Beauty Academy,84,35,3,81
172802,Wright Beauty Academy,45,27,15,30
406200,Wright Career College,1763,1763,1763,0
206613,Wright State University-Lake Campus,1133,912,763,370
206604,Wright State University-Main Campus,16656,14376,12900,3756
441089,Wyo Tech-Blairsville,1277,1277,1277,0
132268,Wyotech-Daytona,689,689,689,0
123208,Wyotech-Fremont,1199,1199,1199,0
240718,Wyotech-Laramie,1462,1462,1462,0
398574,Wyotech-Long Beach,1400,1400,1400,0
445452,Wyotech-West Sacramento,155,155,155,0
234377,Wytheville Community College,3468,1967,1209,2259
481289,Xavier College School of Nursing,52,52,52,0
206622,Xavier University,6633,5512,4811,1822
160904,Xavier University of Louisiana,3121,3012,2942,179
372356,Xenon International Academy-Denver,101,101,101,0
373340,Xenon International Academy-Kansas City,53,45,39,14
407355,Xenon International Academy-Omaha,237,236,236,1
417503,Xenon International Academy-Wichita,286,258,240,46
445984,Xtreme Career Institute,33,33,33,0
237109,Yakima Valley Community College,4105,3287,2873,1232
130794,Yale University,12109,11997,11927,182
130785,Yale-New Haven Hospital Dietetic Internship,10,10,10,0
106148,Yavapai College,8197,4229,2224,5973
245731,Yeshiva and Kollel Harbotzas Torah,46,46,46,0
434937,Yeshiva College of the Nations Capital,45,45,45,0
420325,Yeshiva D'monsey Rabbinical College,53,53,53,0
197647,Yeshiva Derech Chaim,153,146,142,11
375230,Yeshiva Gedolah Imrei Yosef D'spinka,125,125,125,0
481410,Yeshiva Gedolah Kesser Torah,70,70,70,0
247773,Yeshiva Gedolah of Greater Detroit,74,71,69,5
476692,Yeshiva Gedolah Zichron Leyma,23,23,23,0
197601,Yeshiva Karlin Stolin,119,119,119,0
190752,Yeshiva of Far Rockaway Derech Ayson Rabbinical Seminary,57,57,57,0
455257,Yeshiva of Machzikai Hadas,347,347,347,0
197674,Yeshiva of Nitra Rabbinical College,250,250,250,0
431983,Yeshiva of the Telshe Alumni,126,126,126,0
126076,Yeshiva Ohr Elchonon Chabad West Coast Talmudical Seminary,131,131,131,0
197692,Yeshiva Shaar Hatorah,95,95,95,0
441609,Yeshiva Shaarei Torah of Rockland,116,116,116,0
451398,Yeshiva Toras Chaim,182,182,182,0
128425,Yeshiva Toras Chaim Talmudical Seminary,18,18,18,0
197708,Yeshiva University,6747,6030,5585,1162
481438,Yeshiva Yesodei Hatorah,64,64,64,0
363712,Yeshivah Gedolah Rabbinical College,51,51,51,0
451370,Yeshivas Be'er Yitzchok,61,61,61,0
405058,Yeshivas Novominsk,118,118,118,0
197610,Yeshivat Mikdash Melech,164,164,164,0
217040,Yeshivath Beth Moshe,52,52,52,0
197735,Yeshivath Viznitz,604,604,604,0
197744,Yeshivath Zichron Moshe,198,198,198,0
401250,Yo San University of Traditional Chinese Medicine,211,176,154,57
181853,York College,470,453,442,28
217059,York College Pennsylvania,5250,4788,4492,758
420440,York County Community College,1583,953,634,949
418409,York County School of Technology-Adult & Continuing Education,174,94,53,121
218991,York Technical College,5030,3335,2478,2552
217086,Yorktowne Business Institute,122,118,115,7
141361,Young Harris College,1117,1101,1091,26
206695,Youngstown State University,13352,11350,10038,3314
375939,YTI Career Institute-Altoona,405,405,405,0
211750,YTI Career Institute-Capital Region,109,109,109,0
217077,YTI Career Institute-York,2027,2027,2027,0
126119,Yuba College,6874,4083,2672,4202
413820,Yukon Beauty College Inc,17,17,17,0
451237,Z Hair Academy,59,59,59,0
204255,Zane State College,3652,2103,1320,2332
